一径无三径	三径
阶前草色新	新
门前千树树	树
春处已长春	春风
往来天上人	人
何事不还家	家
日日无人使	使
何劳到海涯	劳
一炷一炉香	香
不在其中趣	趣
从来在人间	人间
昨夜听凉雨	凉
一树梅花冻未消	消
又随新雨折新条	新
欲寻芳草桥边路	路
杨柳青青夹路遥	青
不作游人手	手
相从刮后来	剂
游人不相使	使
无复菊花开	复
渺渺长江水拍天	天
分明流水上青天	分明
老来万事全无事	全
不与渔人教钓船	教
把酒一樽酒	酒
清风一夜寒	寒
故人舟上去	舟
昨夜梦长安	梦
别恨都无恨	恨
梅花直不开	直
昨日桃花去	桃花
道人归去来	道人
不是富官官	官
病来过一年	病
老来忽忽忽	忽
不是此花然	花
怒雷轰怒雷	雷
惊起髑髅枯	枯
极目江山远	远
春风也自无	春风
把酒一杯酒	把酒
落日看青山	青山
不是洛阳女	女
也曾在世间	曾
牢落今牢落	落
秋风百尺台	台
游人还自笑	笑
生及到前回	生前
故国风光贯万寅	贯
行人何事未须开	须
东南南北东南海	海
犹有残书寄雁来	书
江上青山看白云	白云
隔溪流水是通津	流水
归来不向船头坐	坐
知是高秋寺里人	秋
杨柳桥边绿树阴	阴
桃花深处伴闲吟	伴
东风细雨随人去	人
不见梅花无处寻	寻
何处不为君	君
从我梦中卧	卧
不作箧中书	书
不知君知否	君
梦里寻花不见花	花
绿阴斜日影斜斜	斜
桃花只在桥边野	野
处处人家未到家	家
风雨到江南	江南
行人忆远公	公
故人争不去	争
细雨忽秋风	忽
江上万重山	山
扁舟日日闲	闲
看来觌面面	面
花影静空山	静
春色白如金	金
无穷亦有心	无穷
往来人不见	人
便是一生心	先生
柴门终日掩柴关	关
只在闲云杳霭间	间
遥望数峰垂尽处	垂
白云犹在五云间	云
疑是谪仙仙	仙
从来无此缘	缘
黄尘尘俗事	黄尘
知是几千年	百年
记得山头一秃翁	翁
西风吹帽起秋风	吹
白头春色浑如锦	锦
只在秋秋暮雨中	秋
宛转如轮转	转
峰头点点金	金
夜来明月月	月
一夜醉猿吟	醉
钟声一夜夜	一夜
月落空阶夏	夏
不是不愁人	人
孤松与松冷	松
百年无病病	病
心事自辽天	天
不是何人道	道
相思思黯然	思
日日出阊门	门
马上金车马	金
一璫都不解	解
把酒一樽酒	酒
细雨不成雨	雨
桃花不是春	春
满空芳草色	空
不是看花人	人
细雨初晴五日晴	晴
蓬窗细雨不分明	窗
小窗夜静珠帘静	静
折得春风自有情	春风
扁舟江上舟	舟
今日上扁舟	今日
天上两白鬓	绿鬓
何人学扁舟	学
江南湖上客	客
暮雨起西风	西风
千帆万帆尽	万
舟散白云中	散
银河河似河	河
明月倚危楼	倚
不是襄阳国	国
年来不胜流	胜
流水桥边路	路
朝来玉白头	玉
行人不相拟	拟
何处问江头	问
落尽江南国	国
秋风弄落花	弄
夜来人不见	人
多在两尧家	丈夫
百年无病病	病
心事亦无人	无人
唯有根根密	根
尊前亦不亲	前
流水桥边路	路
秋风动晚风	动
行人知此义	善
又倒石壶中	倒
白云千万里	万里
风雨到吴吴	吴
不是吴中楚	楚
斜阳水上亭	亭
一树桃花满眼青	青
西风吹作百般声	声
夕阳池上天如雨	天
忽听西风听雨声	忽
流水山前水	水
曾从马上来	曾
游人无处问	问
唯有清风来	清风
三十年来不可供	供
仙人那得白毛毛	仙人
如今不向山中在	山中
安得重来一梦无	梦
江上万重云	云
湖光照眼明	明
不知江上阁	阁
不肯听滩声	肯
白云千万里	万里
何处见亲亲	亲
欲与幽人伴	伴
如今怀主人	怀
水色秋光净	净
落花春草生	生
看来团鼻观	观
一笛吹猿声	吹
杜鹃声里听溪声	声
独向青山处处行	行
却忆一秋江上雁	秋
梅花如月月分明	月
柴门寂寂掩柴扉	掩
一树桃花血不归	血
一阵轻风轻柳色	轻
行人不得故人归	古人
三十年来事不堪	堪
不知何处到幽庵	幽
如今不是知师处	师
只有青山行一庵	行
疑是谪仙仙	仙
我不到扬州	扬州
何容不归去	容
流水绿风流	绿
江南湖上客	客
月上暮潮归	月过
惟有渔舟小	小
墙阴映绿微	阴
战战皆如战	战
床头蜡尚书	架
谁知夷帝子	夷
心是故人书	心
落日风光薄	薄
晴光满气虹	气
知君何处处	君
尚尚系危桥	尚
昨夜春风入帝乡	乡
断肠肠断断人肠	人
谁知万里无人信	信
赢得苏公上玉床	公
朝来一布衣	布衣
回头著衲衣	布衣
白头羞面面	羞
不是路人归	路
一溪流水下浯溪	溪
两岸藤藤挂剡溪	藤
隔岸舣舟人不见	人
扁舟重过画桥西	重
茅屋三间屋	屋
钟声到小窗	小窗
忽来池上客	客
窗外对斜阳	窗外
西风吹雨满天风	风
落尽晴空一扫空	空
只在此间无处处	间
不知心在白云中	心
往来天上人	人
便是一天风	风
扫不扫不扫	扫
不与主人同	主人
渺渺长江水拍天	天
西风吹客系渔船	客
渔人不得行人苦	苦
送送扁舟送钓船	相送
桃花开牡丹	牡丹
粉粉一时娇	娇
恨不随人见	人
侬家折柳条	家
一树桃花陌上莺	莺
更无人事最多情	人
年年不逐东风去	东风
今日谁怜送客情	怜
不向金门启	辟
还将影画眉	影
不知千树树	树
今古已多时	古
不知何处记当年	当年
直到壶中别有天	天
付与游人向东去	东
不知何处访逋仙	仙
来读读书书	书
春草草如草	草
春色已空空	空
朝来恐风雨	恐
往来天上人	人
不是一焚香	焚香
箧中无百舌	百
不是顾天光	顾
今日春来日日闲	闲
春风爽气逼人寒	寒
谁知不是花无意	花
分与江梅烂熳看	分
燕子溪头柳色新	新
家家沽酒买青春	买
桃花不被游人笑	笑
说与渔人作主人	渔人
燕子溪头柳色新	新
落花寒雨不宜春	寒
夕阳堤上桃花碧	碧
知是西湖万里春	春
江上万重云	云
江山江水中	江山
不知君不去	君
不见落花红	红
一叶枝头柿叶红	红
春光多在月明中	月明
谁知不是知音事	音
只在杨花万里风	风
石石石石石	石
婆娑如白莲	婆娑
谁知自有处	自有
为我梦中闲	闲
从来天地宽	宽
不是鬓毛残	残
莫嫌低头看	嫌
浮云隔里看	隔
不见梅花二十春	春
又翻深处见青春	翻
斜风细雨凌风去	风
刚被酸风作主人	风
从来陶靖节	节
何处有清风	清风
独有何人道	道
楼高第一峰	高
万事事难成	成
天风不有声	风
不知亲不祷	亲
犹听唱歌声	犹
三十年来四十秋	秋
西江流水水东流	水
青山处处随人见	人
只在蘋花最上头	花
往来天上人	人
拄杖杖杖杖	杖
细雨满林风	风
长松见松竹	松
小桥流水正弯环	回环
舟泛轻舟系钓湾	轻
买得渔人谁胜胜	胜
一蓑烟雨雨中山	雨
从来陶靖节	节
万事今谁复	复
怜我为谁怜	怜
一笑无一笑	一笑
二十年来何处游	游
故山不见故山愁	山
今朝日日呼归去	呼
犹在岩前一钓舟	犹
不是大文文	文
超然在其宇	宇
唯有天上云	云
不知雨中雨	雨
石上一株松	松
日日无归日	日
不得老僧闲	闲
清思无思思	清思
三十年来事未全	全
不知今日又春妍	春
不知日日无行处	行
今日往来迟黯然	迟
不知何处记当年	当年
老去从来忽忽然	忽
为报主人相报报	报
只教行客客潸然	客
春色白如金	金
明光视寸心	视
光光皆是野	野
处处是贤今	贤
陌上柳条短	短
落花如鉴咦	鉴
明朝出城市	市
那得到山林	山林
水色湖光照眼明	明
更於何处疾平生	疾
不知处处居何事	居
不是斯贤有姓名	贤
不作游人手	手
从来各自先	先
今年无此日	日
黄叶几三年	黄叶
忽忆当年忆昔年	忆
青山都在寺门边	门
归来处处君知否	君
却是西西一钓船	西
一树荷花带晓烟	烟
斜风细雨欲粘天	天
游人不得游人笑	笑
落日晴风吹钓船	风
终日对斋斋	斋
幽人与病来	病
不知民世事	民
挈鳖上山回	鳖
白玉钗头紫绣袍	朱
一帘风露卷珠帘	风
不知只在斜阳里	斜阳
赢得刘郎上画桥	郎
从来朝帝帝	帝
不见山中雨	雨
万事不知非	非
山中有香去	香
扬子山头不白头	头
水光明月照人钩	钩
孤舟独上扁舟去	孤舟
赢得朱芦最白头	朱
儿女蛾眉不画眉	眉
不知何处是愁时	愁
春愁不得愁愁绝	愁
正是愁愁听雨时	愁
佛法无佛法	法
不是如离眼	色相
明明照眼明	明
三千千万万	万
寒食年来岁岁寒	寒食
春风日日兴更阑	兴
不知何处无桃李	桃李
日日酸风耐岁寒	风
老子从来自有诗	诗
六宫何事更迟迟	宫
梅花处处无人识	识
今日吟吟不赋诗	吟
不在山中夜	夜
清光满海波	波
不知芳草草	草
不是奈师何	师
京国令人使	使
谁知柏子子	子
今日无此日	日
愿得山中雨	雨
千峰只在万峰前	前
满地绵绵带暮烟	绵绵
春雨未残归不去	残
夕阳江上水粘天	天
麦麦浑如麦	麦
田田刈刈人	人
那知有春物	春
不是醉游人	醉
江上万重山	山
重来陌上颜	颜
白头春色色	色
细雨雨中看	带雨
记得山头一秃翁	翁
因风细雨唤春风	唤
杖头便向溪头去	石头
只在依然烟雨中	依然
终日出金盘	堆盘
光光与列看	列
不知云雾底	底
何处不耕安	耕
少年何事不相留	留
赢得黄花齿白头	齿
却是他年无一事	年
更无樽酒酹春愁	酒
老去归来杳不闻	闻
秋风飘逐白鸥群	飘
何人乞与春归去	乞
洗尽缁尘一片云	尘
何人识此心	心
不复出山山	山
白石桥边路	路
从来不上关	关
何处是诸贤	诸
老眼不具眼	眼
从来罗缝底	底
不是一时处	一时
不是野人居	居
谁能与我乐	乐
相对北窗窗	窗
一夜清风起	清风
朝来暑气侵	侵
幽鸟不知春	春
惟有佳人耳	耳
何应惜故人	惜
微风细雨共清寒	清寒
料得人心孰自难	孰
安得西来怕风雨	风雨
故人犹向雪中看	犹
何处见梅花	梅花
梅花恐恐斜	恐
夜来风不露	风
人见看梅花	人
习气烈温温	烈
衣冠冠冠冠	冠
谁能知此世	世
终日叩门门	门
斜风细雨扫空空	空
深院深深细雨中	夜深
三十六宫无底事	宫
诗人只在诗人中	诗人
三十年来两鬓华	华
梅花如玉玉无瑕	玉
如今不是怀常事	怀
强趁春来一雪花	健妇
渺渺长江水拍天	天
行人犹恐误渔船	恐
当时鸥鹭知何处	当时
只有扁舟上客船	客
万事不容容	容
何如双羽羽	羽
今年不如昔	昔
独向庭庭老	庭
三十年来尚尚余	尚
萧萧修竹竹萧疏	竹
争争底事知何事	争
赢得闲身独读书	身
扁舟江上上扁舟	龙舟
呼系扁舟系钓舟	呼
却是扁舟两行处	行
直从滩上一搔头	鼻
何处是诸贤	诸
人心不谩传	谩
须知万里行	行
桑鹞过桑田	扶桑
千峰只在万峰前	前
长笛数声过水边	数声
归去不来岩影里	岩
故人长话话依然	话
少年何事太匆匆	太
一炷炉香一梦中	香
老老不知身已老	身
夜来春梦梦秋风	梦
野花不种花	野花
老子亦有名	名
欲向天上行	行
故人还自分	分
细雨淤泥泥	泥
轻风细细长	细
主人无限意	意
不令到斜阳	令
细雨湿罗衣	衣
桃花两鬓华	华
主人虽不使	使
年是种桃花	年
石石石石石	石
山中紫霞紫	紫
我来无处问	问
只在山深处	山
一夜东风五月寒	寒
白云飞上武陵滩	滩
山中只有白云卧	卧
乞与诗人有意看	有意
疑是谪仙仙	仙
焚香桂香里	香
处处是蝴蝶	蝴蝶
不知岩下宿	宿
青山何处见青山	青山
杨柳桃花自往还	杨柳
想见桃花枝上坐	坐
不知君不在人间	君
一树桃花未肯归	肯
又随风雨袭人衣	人
西林只在深林处	西林
不见桃花春不归	春
白玉楼前玉殿开	玉殿
桃花深处引徘徊	引
多情不似阶前水	水
燕子应难不放来	难
流水山前水	水
江山日暮愁	愁
湖光照前水	前
不是梦中秋	秋
西风吹雨满天风	风
春色谁怜日月中	怜
一树桃花春已尽	春
不知何处费春风	费
一树梅花乍乍开	乍
黄毛枝上雪花开	霜毛
故园春色浑如旧	旧
不见梅花入梦来	梦
不在山中夜	夜
看来不转转	转
月照千峰影	影
骊山岩下水	水
白云深处护高峰	护
只有霜霜半夜钟	霜
一夜松风风雨去	松风
谁家山水照芙蓉	山水
昼静闭门静	静
半残花影残	残
不知关上玉	玉
处处隔云看	云
昨夜东风咽不流	流
南山草木替离愁	草木
朝来独有山中药	药
多谢恩深送客愁	深
老去归来鬓似霜	霜
晚来何处见春芳	春
城头柳色寒如雪	寒
日日寻诗到海棠	诗
街头儿哺儿	儿
走马走惊梭	惊
不知使君去	使君
应不识如何	识
春色浓如锦	锦
重来不忆君	君
可怜湖上客	客
愁杀是离人	愁
本来都不记	记
不是是於人	人
自笑不相笑	笑
今春不是春	春
习气千年气	气
须知别有天	天
不知吾自喜	喜
兄弟自相传	兄弟
杨柳桥边绿树阴	阴
游人醒处恣吟吟	醒
行人更欲寻山去	山
白鹤归来一寸心	白鹤
五日十日醉	醉
今年不赠君	君
朝来北窗下	窗
今日怜送君	怜
流水山前水	水
孤云杳霭间	间
扁舟何处弄	弄
疏影上疏竿	疏
西风吹雨满天风	风
一树残花绿草中	绿苔
落日落花还寂寞	寂寞
梨花春雨不成空	空
一树荷花带晓烟	烟
人间处处变桑田	人间
游人记得僧归去	僧
犹记归来二十年	犹
陌上紫罗罗	罗
一树桃花树	树
吹落一枝枝	落
不知归晼晚	晚
茅屋茅茨绿水傍	傍
竹篱茅屋破绳床	破
夜来枕上三十里	十里
须卧禅床卧石床	须
春来春意深	深
独向池边月	月
独在静闺中	静
临风不相弄	弄
白鸟忽飞来	忽
扁舟行不回	行
可怜堤上柳	柳
何处又腰回	腰
一夜东风五月寒	寒
落花漠漠晓天寒	败叶飞
海棠花落空空去	空
不似当年一病看	病
不知何处是寻常	寻常
细雨掀泥草草场	泥
明日白云无尽日	日
将军何处不开场	将军
少年三十载	五载
不是孰相求	孰
浮云与云去	云
何处见孱颜	颜
去年今日又春风	春风
万事无情万物同	万物
又向落花催去去	催
主人明在向东东	明
千峰只在万峰前	前
万里青山紫郁然	紫
谁知不是人间事	人间
试问壶中别有天	天
杜鹃声里听溪声	声
啼鸟数声春鸟声	春
明日白云无尽日	日
隔山犹有几人行	人
三十年来四十秋	秋
一家风物富春秋	春
老来何事今何事	何事
白鸟飞飞送客愁	飞
蜡梅枝上一株梅	梅
小摘梅花贴眼开	小
不是主人谁可赠	赠
又随春雨又生来	生
昨夜东风暑气凉	凉
一楼明月一窗明	明
青山不在山深处	山
鸥鸟归来独自惊	惊
主人无道道	道
不是赵州州	州
不是英雄气	气
淳风第九秋	风
流水漾沧波	波
荷花映绿荷	绿
渔人争缺处	争
何处识烟波	识
江上万重云	云
青山寺里僧	僧
澄江空似水	空
何处向华经	华
白头狮子子	子
赢得山中雨	雨
不是也无愁	愁
具足不足足	足
明月湖边月	月
轮轮入玉楼	轮囷
夜来风影影	影
和气袭人愁	人
世事从来万事非	非
百年心事不知非	非
年来不与行人送	送
乔蔓摧惶又不归	乔
细雨不成雨	雨
膏膏拨不开	革
可怜空草色	空
不向鬓华来	华
江上北风吹	风吹
愁人白羽衣	人
武陵山下路	路
独向道南归	道
记得一尊尊	尊
不向此中语	语
不见天上云	云
处处无行路	行
日暖初初暖	暖
榴花独自芳	芳
落花无限恨	恨
将影入禅房	影
不是洛阳女	女
梅花桂树香	香
真人何处在	真人
虚对桂花香	虚
老子从来不可推	推
今年何事少迟迟	少
满城风雨催花发	花
今日缓游知几时	游
梦里寻花不见花	花
老来不觉觉生涯	觉
老来自是无情物	物
东水人家卖酒家	江水
西风吹雨满天风	风
不见龟毛上角鸿	毛
何事不知王好事	王
至今惟在月明中	惟
五日十日醉	醉
游人不自持	不自
竹床欹枕枕	枕
正是月来时	月
主人无道道	道
独向苔痕湿	湿
有果有行人	果
不觉全无事	全
茅屋今无数	数
明朝谒帝乡	帝
不知家汉国	家
不是冠冠章	冠
五日十日醉	醉
恼渴也不多	解渴
老子自有来	自有
其奈渠奈何	渠
何处不为君	君
江山各自陈	陈
雨来泥滑滑	泥
中有一綦尘	尘
不是富官官	官
回头路屈盘	路
柴门不掩关	关
却向水中渊	渊
山中无隐隐	隐
一炷一炉炉	炉
梦觉真成梦	成
龙气入乾坤	龙
万里青山迥不孤	孤
江南南北是吾庐	南北
洛阳池上雪如雪	雪
不见梅花不是无	梅花
江上一帆帆	帆
归来不得名	名
不知浑底事	浑
临虢一行行	临流
不向山中宿	宿
至今犹未归	犹
梦魂消不尽	消
何处不虚归	虚
斜风细雨扫空空	空
万事无余在有中	有余
不是游人劳好事	劳
依然顶上不相同	顶上
昨夜东风咽不流	流
主人无食替人愁	食
向来直下今天下	直下
佛祖如今不白头	佛祖
夜来冰雪中	雪中
天下天如天	天
不知何处游	游
不认山中传	认
往事如相问	问
飘然万里风	风
今年千岁岁	岁
已觉落花中	觉
日日无归日	日
黄花处处腰	腰
不知君不去	君
寻泊泊溪桥	寻
车马归来去不惊	惊
一番风雨一番新	新
谁知不是南阳女	女
不见楼前两鬓银	银
林下响缫车	车
龙车走马车	车
不知无日日	日日
白浪望沧浪	白浪
不见梅花二十春	春
却游今日看红尘	游
今年不是年年好	年年
不是荼枯是故人	枯
一炷一炉香	香
从来不见山	山
归来未休去	休
知是旧时原	原
佛法不不悟	悟
无非不是求	求
一体无圆偈	圆
从来不是香	香
从来不可调	调
处处不相留	留
不是主人意	意
人心无费谋	费
风雨正凄凉	凄凉
胸中一寸囊	囊
不知何所忆	忆
烟雨不凄凉	烟雨
二十年来何处游	游
不知何处许风流	许
去年今日不归去	今日
不见青山最上楼	楼
行人不复复	复
风雨往来风	风
自是人情薄	薄
黄花不谢公	公
一树桃花满眼青	青
荷花十里已青青	十里
轻风细雨冲云去	云
巧尽梅花满白萍	巧
不向青山住	住
从来万事须	须
年来无限思	思
不是镇回途	镇
平生不得老书生	书生
世事谁欺与此生	欺
我是使君君知否	君
一窗风雨听风声	风
一溪流水下浯溪	溪
鸥鸟不须到此时	不须
不见梅花慰牢落	落
看来还是故家诗	家
江南湖上客	客
归去几时休	休
日日来相访	访
黄花禁客愁	禁
少年何事事犹犹	犹
唯有风光拂翠岚	翠
自是元来无一事	元
不知天气是乾坤	天气
三十年来四十秋	秋
百年心事喜离愁	喜
如今万事随人见	人
始觉如今有客愁	始
万里江山隔	隔
行人不相逢	相逢
归来不相忆	忆
今日与君同	君
昨夜春风入六宫	宫
千千万万暮云中	万
东风不逐东风散	散
一树桃花在汉中	汉
不作蛟龙走	走
谁知万里春	春
不知千日醉	醉
缘是白头人	缘
昔日游人少	少
谁知得意时	得意
看来面面面	面
不是是郎时	郎
明月湖边月	月
桃花簇带金	金
何人得仙去	仙
知是武陵陵	陵
白水浮云万里行	行
小桥流水不纵横	纵横
小桥流水桥边路	路
须得扁舟第一行	须
江上晓来来	晓来
祗从天上来	但见
不知今夜夜	昨夜
残月照残灰	残
不知何处是芳菲	芳菲
不见梅花处处飞	飞
零落落花人不见	人
又翻风雨送春归	翻
万顷平沙涨浅沙	沙
不知身在野人家	身
不知到处知难处	难
两鹿从来是几家	鹿
不作骚人咏	咏
焚香细细评	细
西风一曲曲	曲
东畔寂无声	东
何人识此心	心
彼此不相负	负
不在三峰前	前
独有柏柏子	子
一树荷花带晓烟	烟
诗人风月逼人眠	诗人
行人折得桃花发	花
流水归来水自然	水
昨夜春风入帝乡	乡
不知何处赖霓裳	赖
宫中惟有蒲萄酒	酒
静听檐声不断肠	声
东风催晓晓	晓
细雨发荷花	发
记得新新雨	新
秋霜是岁华	秋霜
杨柳桥边绿树阴	阴
山中有客不伤心	客
如今不向西江去	西流
不见青山有月心	月
龙飞天上白云飞	龙飞
车马东东去不归	东
今日侍臣南北望	臣
满城烟雨湿烟衣	烟
江上万重山	山
相寻远往还	寻
往来年不去	年
心事在人间	人间
燕子移来兴未移	移
春风日日少迟迟	少
荒荒柳絮乍归去	荒
不见梅花入草时	草
山色重重重	重
东风五月寒	寒
主人何处去	主人
终日不相看	终日
二十年来鬓鬓斑	鬓
此身那得此身闲	身
千年万事随人见	人
唯有虚名在世间	世间
不向金门启	启
如侬是圣人	不识
主人羞杀杀	杀
不是太阳春	太
不作行人画	画
归来忽忽来	忽
主人题旧句	题
白鹤白云开	黄鹤
陌上桃花一样妆	妆
桃花深处与芳芳	芳
今年不逐东风去	东风
蜂蝶争教不放忙	教
白玉峰头白玉玉	玉
我来天下一身身	身
谁知此去还须去	须
不见林林是主人	林
不是谢公公	公
萧郎老老翁	郎
清风与风雨	风
日日送秋风	送
相望青山接	接
处处有人家	家
浮云无尽日	日
春入碧桃花	春
百年何事事难难	难
赢得长江一浪宽	浪
极目江山皆四海	四海
不宣天上到天寒	宣
亡国从来始始知	始
凤凰台上影迟迟	影
如今万里无行路	行
始是今年有别时	始
东风吹雨趁西风	西风
梦里时闻入梦中	闻
正是桃花最深处	最
只应明怨怨春风	明
从来世事基	基
惟有一株梅	梅
日日东东去	东
梅花一木开	木
湖边春草生	生
漾漾沧波底	底
摵摵暮潮来	牢
幽禽自鸣去	鸣
青山连野野	野
家在画桥西	西
惟有渔人令	令
行人误淤泥	误
不是富官官	官
真宜事自难	宜
老来都不送	送
只向落中看	落
江上万重云	云
孤云不可攀	不可
向来曾不见	曾
不向梦中安	安
从来都不取	取
不是主人居	居
圣命不如汉	汉
不堪愁读书	愁
天子从来势未干	干
谁知清净到长安	清净
行人留得红红白	红红
说与诗人不识看	识
细雨不成雨	雨
归来不见梅	梅
池塘何处处	池塘
应是一吟来	吟
江上万重云	云
猿声处处闻	闻
向来无处问	问
孤月照孤云	月
不知何处是先生	先生
险险犹堪十十程	犹
今日乞从天上去	乞
世间万事竟难成	成
日日出阊门	门
落花成底事	成
唯有故人兴	兴
飞来惭白鹤	惭
老子何为尔	尔
先生亦不喜	喜
何处见梅花	梅花
不见庭前树	树
一树梅花处处佳	佳
故原遗迹在天涯	原
个中唯有游人意	意
不是游人休叹嗟	休
青山何处见青山	青山
啼鸟寻春去不还	春
今日不知春色胜	胜
桃花枝上玉孱颜	玉
不在山中夜	夜
不作梦中梦	梦
明光照眼明	明
一声声不断	声
何处不为君	君
飞来江上溪	溪
不随金白雁	金
数在画桥西	数
百百三年二百年	百
今朝风雨满京尘	尘
不知今日容归去	容
不愿青山作主人	愿
江上雁飞飞	飞
吴河归雁归	河
春风花影里	春风
不是泪痕归	泪痕
不向山中美	美
游人伴寂寥	伴
墙阴松树下	阴
飞上碧层霄	碧
不知何处是文章	文章
一夜秋风思故乡	思
不是主人须底事	须
故将双泪到书床	书
清风一曲曲	曲
不是山中客	客
行人去不收	收
归去去休去	休
一炷一炉香	香
枝头一点红	红
谁知与公子	公子
知在武陵东	东
老来何事不愁愁	愁
静听鸦啼不尽愁	啼
折得梅花无限思	思
且将樽酒送春愁	酒
不作蛟龙箭	箭
浑如掌掌平	平
当时无妙处	当时
不是落精坑	落
临水登山不可登	登
隔溪流水欲微冰	微
湖光山色浓如锦	锦
不见扁舟迟暮汀	迟
饱食虽无食	食
居然与剑颠	剑
南山行乐处	南山
春草草生田	生
从来真翰墨	翰墨
今日少年时	今日
今日不相失	失
故人今始知	始
自在山中坐	坐
溪流水自流	水
纷纷在何处	纷纷
归睡不回头	睡
老来人意扰人情	人意
独向孤云处处行	行
遥望远山归远远	远
鸟声无远听猿声	远
亡国从来事不优	优
平生何事感悲俦	感
闺中尚有行人恨	恨
涕泪还须上戍楼	须
风雨到江南	江南
苕溪上画桥	溪
六朝三月里	六朝
行人入画图	画图
三十年来不可言	言
严严何事更超然	严
不知不在依前后	前
不到江南二十年	江南
世事从来不是俱	俱
世间间事两纷纷	间
如今更向林泉去	林泉
唯有名名与白云	名
流水桥边路	路
秋风起晚风	秋风
不知君不去	君
明月月明中	明月
一炷一炉香	香
阶前叶叶黄	黄
圣人都不姓	姓
知是白杨杨	杨
老来都不喜	喜
留得一秋秋	秋
记得归休去	归休
相寻迹自幽	寻
从来不用用	不用
不是不相期	期
不得三千寿	寿
与君君不知	君
西风吹雨满天风	风
流水芦花绿水中	水流
我欲为伊何处去	伊
一声闻听笛声中	闻
极目青山杳霭间	间
使君终日与君还	君
西风昨夜香归去	香
一夜西风夜月寒	寒
杨柳萧条绿	绿
清波水上来	清波
不知春色少	少
春色莫嫌开	嫌
万事不容容	容
双猿去不去	雏
江南春水平	平
不向江南道	道
日日出阊门	门
东风看晓烟	烟
已枯黄叶老	枯
犹在石门前	犹
三十年来四十秋	秋
长安心事不回头	长安
青山处处君知否	君
一夜寒寒送客愁	寒
江上千竿竹	竹
曾从天上来	曾
夜来人不见	人
一夜夜香开	香
乔木自琅玕	琅玕
落日秋风散	散
落日不归日	日
行人不相直	直
一树桃花菊未残	残
今年为客到长安	客
不知只在秋光里	秋光
乞与高人醉眼看	人
白玉峰头白玉玉	玉
枝上花开花影迟	迟
老来不是天涯事	天涯
卧看闲云细雨时	穿云
腰腰白帽髻腰腰	缠
春色初遮半不娇	遮
知是洛阳桥上脚	脚
美人骑马信东桥	信
一树桃花烂未开	蕊
萧萧风雨雨莓苔	雨
个中只有文章事	文章
只恐真成独往来	成
世事无多感	感
萧然万古风	风
故人都不识	识
应在此花中	花
一树荷花带晓烟	烟
淡烟晴雨湿晴烟	雨
西风一笛吹吹笛	吹
添得芦花处处眠	眠
一炷一炉香	香
洞洞主君子	洞
日日泄春光	春光
松柏独自瘦	瘦
万事无人识	识
不见山中碧	碧
明光照眼眼	眼
直下更何如	何如
不得黄金臂	臂
从来不倒翻	沫
不是无人会	无人
一夜一销魂	一夜
杨柳湖边柳	柳
杨花老妾身	身
不栽桃李老	栽
春处是长春	春风
湖边春草生	生
细雨怯寒寒	寒
处处无书雁	书
灯明意自宽	明
江上万重山	山
江南古城古	古
何处出波波	恩波
不见东塘水	水
斜风细雨扫空空	空
多在秋心入梦中	芳心
想见梅花枝上雪	雪
别来犹有一般风	风
从来勘不破	破
细雨打窗窗	窗
自是无行路	行
休休日夜忙	休
一树桃花艳不妍	藉
夕阳归雁楚江边	雁
不知此去曾何处	曾
独向西风到竹边	竹
往来天上人	人
世事迟迟迟	迟
不知江上春	春
主人意迟迟	意
一树桃花各自娇	娇
妻孥归去不长条	妻
寸心自是伤心事	寸心
只恐梨花在画桥	恐
池上雪如雪	雪
暮云看白云	暮云
何处闻猿唳	闻
山色妒江云	妒
流水山前水	水
西风落花发	发
去去君不来	君
处处君知否	君
车马归来去不惊	惊
行人不向梦中行	行
行人若欲寻春去	春
惟有溪头新雨晴	新
只在西湖上	湖上
归来看白云	白云
不知生险处	生
归去亦何稀	稀
不见梅花二十春	春
别来不见一番新	新
山中只有桃花火	火
北北青山作主人	北
一树桃花满眼青	青
重来重见故山青	山
西湖万里三千里	万里
不见青山间树青	间
一炷一炉香	香
无心不是疑	疑
一年一分别	一年
仙去竟何疑	仙
杜鹃声里听溪声	声
花影初低过几程	低
直到平明何处事	平明
画桥西畔两三声	西
老去归来不可寻	寻
满山流水放人心	放
谁将一片片云去	一片
付与游人嗔苦吟	嗔
昔日出衡衡	衡
东风怕风雨	风雨
晚来江上溪	溪
知是渔舟客	客
孤舟江上一扁舟	孤舟
记得群群送远游	群
世事相容莫归去	容
青山只在浙江头	青山
春色已纷纷	纷纷
春来不到家	家
桃花树深处	深
何处见桃花	当年
钟声午夜钟	钟
处处在人间	人间
不是吾先事	先
行人看取还	取
何处不为君	君
人心本无心	无心
不是人间事	人间
雪雪无人心	雪
老子从来自有诗	诗
百年心事不相追	追
青山处处君知否	君
送我归来更有诗	诗
春来气未平	平
处处不相寻	寻
游人暂归去	暂
风雨满秋林	秋
翻身是此身	身
不是不为人	人
不得箧中书	书
不是不识真	不识
翻身是此身	身
万事亦不陈	陈
不惜白衣衣	衣
不知日行人	日
牢落今牢落	落
江山雪如雪	雪
行人无使归	使
惟有春风雨	春风
一叶枝头柿叶红	红
西风吹雨满天风	风
今朝不是明朝事	今朝
不见桃花眼自空	空
积雨堕不堕	堕
幽人寄故人	寄
青山桥下水	水
流水漫津津	漫
朝来春气浓	浓
江水水如水	水
鸿雁过浔阳	阳
吴江楚江雨	雨
白日青山小	小
青山古寺前	前
愿陶江上去	陶
临水景依然	景
流水桥边又一竿	竿
年年风雨怯春寒	年年
东风走马凌烟去	烟
折得梅花五月寒	寒
世上无纤手	空手
行人一骑来	骑
往来人不见	人
不逐水流回	水
二十三年三岁岁	岁
如今已傲已多时	傲
如今今日君知否	君
正是今年不遇时	遇
二十年来鬓鬓斑	鬓
诗人把酒送诗还	诗
归来欲去还须去	须
付与诗人写往还	写
不知何处是功名	功名
忽听西风听雨声	忽
万事不知心事变	变
只将心事不分明	心
从来亦有神	神
妙者不可闷	恣
谁能知此意	意
不是第一人	第一
青山天地藏	藏
飞出洛阳宫	宫
落日无行路	行
休看落照中	休
青山无觅处	觅
陌上委埃尘	尘
唯有怀宾客	怀
如今足主人	足
老去归来杳不闻	闻
至今谁与道相闻	道
如今更向西山去	西山
正是夕阳白鸟群	夕阳
此性从来本自求	求
一江流水自空流	空
如今不见庭前树	树
只在群花最上头	花
不到扬州是赵州	州
更将终日放鳌头	放
个中只有山头色	色
雷鼓一声溪水流	声
西风吹雨满庭庭	庭
一夜东风过旧亭	旧
不是主人无处问	问
不知何处有文经	文
春色浑如旧	旧
浮云万里开	万里
主人容易易	易
犹自放船来	船
山色重重重	重
千山雪雪中	雪
满山残雪里	半山
那得约相同	约
细雨不成雨	雨
不知春色多	春色
游人归去晚	晚
直直上嵯峨	直
法界千界界	法界
谁知不是人	人
一鎚如铁箭	箭
不是现前身	前
杨柳萧条短短堤	堤
不知何处复东西	复
不知今日从君去	君
草草苔痕白鸟啼	痕
渺渺长江水拍天	天
行人难买渡溪船	难
舣舟渔艇教归去	教
更上渔舟上钓弦	弦
美人开玉座	玉座
池上凤凰车	车
汉汉不如汉	汉
谁能作虏驱	虏
杜鹃声里听溪声	声
安得长安得不生	不安
记得归来是黄老	黄
老来何事不劳名	劳
一树桃花满眼青	青
一声箫鼓鼓江城	鼓
谁知不是州州事	州
赢得无人作此行	无人
白头山色几重重	重重
鸥鸟相呼去不同	呼
老子从来不收拾	收拾
却教烟雨趁西风	教
细雨归来暑气微	微
斜风细雨扑香衣	香
轻风细雨还收去	收
却向梁梁处处归	梁
天上楼台百尺台	台
玉楼新筑上楼台	新
三公不是王公事	三公
一贺君王去不回	贺
三十年来四十秋	秋
十年三十到扬州	十
如今说与行人语	语
今日知君不白头	君
白头狮子子	子
不见眼中花	花
不是今年岁	岁
楼台万万家	楼台
二十年来何所期	期
金鞍席上看花枝	玉立
桃花藏尽槐花树	藏
今日看花人不知	人
春水千峰碧	碧
湖光杳霭间	间
舣舟江上去	舟
鸥鸟不言还	不言
二十年来何处游	游
一家风物富春秋	春
不知今日无人信	信
只在青山东水头	江水
斜风细雨扫空空	空
一树榴花在影中	影
燕子归来无数数	数
却将时节献残红	献
何处是平生	平生
新诗诗不成	诗
文章无一事	文章
知是武陵陵	陵
往来天上人	人
秋色扫空空	空
中有书中书	书
夜夜听秋风	秋风
西来沧海东	东
别殿月光中	殿
日暮夕阳暮	暮
满城花晚风	花
三十年来四十秋	秋
老来无计自疏修	疏
山中尚有多情思	思
折得梅花总是愁	愁
少年何事太匆匆	太
只在尊前一梦中	前
记得洛阳关上锦	锦
如今只在白云中	白云
江上万重云	云
漫漫绿水中	漫漫
江南秋草草	秋
娥在月光中	娥
自在山中坐	坐
依然卧剡中	卧
不知岩石间	间
处处有诗穷	诗
不到扬州是赵州	州
全身赢得一身谋	全身
举头不得从渠去	渠
不是渠渠不白头	渠
从来独自修	修
通方通法直通通	心通
不得眼中书	书
一默闭无聋	闭
千年万事不轻轻	轻
又向东风寄此声	声
唯有游人频旧事	频
老来不得姓名名	名
堂堂堂上玉堂堂	堂
时听蝉声送夕阳	送
不是主人寻处处	寻
洛阳城上几重阳	城
万事事难成	成
谁能终此生	终
谁知诸诸子	诸
从此总功名	总
万事事难成	成
依然在九庭	万条
不是裁纨扇	裁
春风风动故人情	春风
石上一株松	松
千岩一径通	通
不知力筋力	力
付与主人功	功
渺渺长江水拍天	天
晚风吹雨欲粘天	天
湖山夜雨知何处	山
白鹭飞飞泊钓船	飞
江上万重山	山
新翻水拍湾	新
不知非世事	非
明月逼人寒	寒
不是主人主	主
重来别有诗	诗
往来还有句	句
何处有清诗	清
不见梅花二十春	春
不知何处驾红尘	驾
西成记得栽成去	西成
颜色依前是主人	前
梦里寻花不见花	花
与儿啼处听啼鸦	儿
行人到处无行处	行
肠断小桥横酒家	横
日日过日日	日日
酒醒都未醒	醒
不是去年年	今年
不觉一书夜	书
百年无病病	病
白日对青灯	青灯
夜夜谁闻语	闻
东风宿雨多	雨
江南湖上客	客
白雁忽归来	忽
今日非何事	非
林林次第开	林
爽气满沧洲	沧洲
扁舟水上舟	舟
森森苍翠岫	护
春色不回头	春色
老眼不具眼	眼
身心总自缘	总
看来浑不了	浑
到此晚依然	晚
独倚危楼倚倚栏	倚
游人不向醉中看	醉
飞来鸥鹭放归去	放
江上扁舟休钓滩	休
细雨湿罗衣	衣
落花金一围	金
不知池上土	土
蝴蝶不争归	争
梦里寻花不见花	花
满城风雨又春斜	春
春来不觉游人觉	觉
犹有东风落杏花	落
往来天上人	人
寂寞还寂寞	寂寞
主人遇主人	遇
一夜过一夜	一夜
高峰来咫尺	咫尺
天下太虚虚	虚
独向阶前后	阶前
须知此夜无	夜
往事如相问	问
一蓑独往来	蓑
不知千树树	树
看得几人回	人
不见梅花二十春	春
杏花烟里惹红尘	烟
不知日日归来懒	懒
偏与桃花恋故人	偏
何处是刘郎	郎
王郎似妾郎	郎
不知通处处	通
谁信是王郎	信
春来春意深	深
不觉觉时觉	觉
不知天上木	木
知是幽人道	道
不作游人手	手
从来岂不遥	遥
往来虽不隔	隔
孤月照孤桥	月
江上万重云	云
今犹旧泪痕	犹
朝来有新酒	新
惆怅入柴门	频
江上万重云	云
阶前白玉玉	玉
飞来雪雪中	雪
何处相相寄	寄
流水自清清	清
春风自有情	春风
池塘春水阔	阔
不见柳青青	青
昨夜秋风急	急
孤山万里中	万里
功名何处在	功名
谁道有秋风	道
少年何事不相携	携
正是山中宴坐时	坐
今日归来不相喜	喜
不知何处是愁时	愁
一树桃花菊未残	残
秋风不怯晚风寒	秋风
不知日日无归日	日
且作湖山满眼看	山
白云深处昔曾曾	曾
此去从来亦有秦	秦
归去往来谁复见	复
公知何处是闲人	公
江上万重云	云
看山不见山	山
始知知有始	始
今日几时还	今日
落日秋风动	动
飚髯自可人	馋涎
归来穿石石	石
造物性精神	性
何人识此心	心
不与一生生	生
清香不是香	香
皎皎吸风清	湛
行人不复复	复
只在青山底	底
无人问不来	问
不是鸟鸣去	鸟鸣
流水自清清	清
天上星星斗	斗
青山路不通	路
处处行行路	行
不见庭前树	树
行人抱抱来	抱
吴王谢何事	王
百尺一千回	百尺
白云深处锁烟霞	锁
面面清光射彩霞	射
五色雾中春色紫	紫
不知何处拜烟霞	拜
何处是刘郎	郎
西风骑马马	马
百年千岁年	年
今日知君否	君
一溪流水下浯溪	溪
一树荷花冷碧溪	冷
自是行人一行处	行人
小桥风雨思东西	思
明月满江江	湘江
长江江水流	流
伤心无此心	心
流水两悠悠	悠悠
归去不归来	归来
伤心都不记	记
美人妒妾意	意
犹恐随人去	人
江上青山处士家	家
欲鞭车马出京华	鞭
桃花处处随人见	人
不见门前一树花	门前
平生何事不先先	先
风雨经秋亦飒然	秋
自是元元无一事	元
老来心事亦依然	心
漠漠长江漠暮烟	漠漠
满堤杨柳映青烟	映
谁家儿女山头手	手
今日相宽二百年	宽
车马无车马	鞍马
青山杳霭间	间
行人苦辛苦	辛苦
留得夜归还	夜
何事更多情	交情
茫茫极世情	茫茫
不知安得处	安得
期是故人情	期
良时不在旧时时	之时
万事多情难不知	难
今日扁舟来往去	危疑
山中唯有几人知	人
千年万事不轻轻	轻
今日思君去不行	君
一念归来无念念	念
他年何处听泉声	年
身世不为世	世
无言信不信	信
朝来不上城	城
莫向当门白	门
何处不为君	君
万事不可备	备
三清自清清	三清
日日与天雨	天
老来都不喜	喜
心事不分分	分
到此不相想	想
应无一纸书	书
叶叶叶叶叶	叶
微风尽日长	日
谁知有生处	生
蜂蝶去还忙	忙
洛阳亭上倚危亭	亭
想见山中一夜灯	灯
明日白云无尽日	日
不知洞口一山僧	口
静听钟声第一声	数声
不将孤梦到家行	家
不知疑是山中事	疑
一夜冲寒听雨声	寒
一炷一炉香	香
人心无尽日	日
夜窗一睡起	睡起
不觉不知迟	迟
江南湖上客	客
望邑洛阳城	邑
遥望深山里	深
断肠第一声	肠断
江上万重云	云
西风满山雪	雪
有骨自有骨	骨
只在澄潭里	潭
梦里寻花不见花	花
一溪流水一溪斜	溪
扁舟十载不归去	十载
不见青山山在家	山
昔日游人少	少
如今谢武王	王
应须待君子	须
书不是中郎	书
明月湖边月	月
钟声一夜声	声
澄波波不起	波
卢得一经行	曹
杨柳萧条上柳条	萧条
又催春雨过东桥	催
可怜万里凌风雨	风
又向青山过小桥	青山
黄叶枝头柿叶黄	黄
桃花不见杏花香	桃花
春风自在春风里	春风
明日偏偏春日长	偏
春梦都如梦	梦
伤心事已空	空
欲行山下路	行
终日忆苏公	公
不是祖师师	师
谁能听此声	声
虽然扶不得	扶
不到不须行	行
不见梅花二十春	春
百花千里惹埃尘	尘
谁知物色无中色	绝色
知是山中有几人	人
白日青山小	小
西风隔浦风	风
乱山深处处	山
藏在白云中	藏
美人朝宴罢	罢
日日倦徘徊	倦
不知主人在	主人
寄书寄雁来	书
少年何事不知予	予
三十年来计未终	终
岂是身心如此地	此地
归来不作瓮头春	春
白玉峰头白玉玉	玉
洛阳天上浮云度	度
春来到处不知非	非
不见梅花好风月	梅花
自在山中坐	坐
归来不见竹	竹
不是铁如铁	铁
归来不相问	问
百年何事事难难	难
今日天风日日寒	风
归去不来人不见	人
诗人不作放翁看	翁
往来天上人	人
前身是此身	身
不知谁不解	解
啼鸟不知春	春
三十三年与旧游	胜游
归来日日日风流	日
不知今日谁相顾	顾
每到青山去未休	休
竹林深处听鸡鸡	鸡
惟有行人尚有诗	诗
枫叶满林秋夜雨	秋
西风吹雨过风时	风
相似向来时	相似
伤心不是道	道
谁知死不死	死
何处有新诗	新诗
流水桥边路	路
欲向江南道	道
相望远山远	远
江山暮潮度	度
百年何事事难难	难
故人寻处到长安	寻
怅望青山一千里	千里
故人争向镜中看	争
不见梅花二十春	春
可怜花发不宜春	花
东风不吹西风去	吹
相伴閒眠作醉人	眠
记得山头一秃翁	翁
青山千里一天风	风
如今不得闲身去	身
直到虚空眼自空	空
不见梅花二十春	春
今年春色不愁人	人
可怜陌上千株柳	柳
一缕丝丝作美人	丝
北风吹雨入深山	深山
疑在寒云杳霭间	云
只学扁舟看不得	学
却随风雨动江山	动
年来何事不沾衣	牵衣
岂是人心总是机	机
赢得白头还白日	白日
至今犹向白头归	犹
斜风细雨扫空空	空
楼上楼高一半空	高
不是主人无限意	意
游人只在向西东	西
江北风高意气高	高
行人赢得十三三	十三
谁知不是南阳女	女
北望青山天不遥	天
极目青山杳霭间	间
一江流水发云山	发
不知何处令归去	令
记得扁舟趁晚还	晚
江上凭危阁	阁
孤山雪雪中	雪
楼台明月冷	冷
闲在玉楼中	闲
燕子溪头柳色新	新
小桥流水满山根	根
老来何事缘何事	缘
飞入青山深闭门	深
流水满江水	湘水
渔舟万骑来	万
安得郎归去	郎
惭愧扁舟回	惭愧
洛阳亭上倚危亭	亭
山色空空映月明	空
不是主人今日醉	醉
满山今日买山行	山
江上万云山	万
茫茫杳霭间	间
扁舟舣舟去	舟
不是渡湖船	船
老子从来自有诗	诗
今年不是雪晴时	雪
夜来春梦浑如梦	梦
正是梅花欲雪时	雪
世事从来万事非	非
百年何事为胡归	胡
老来不得书书在	书
今日归来乐不归	乐
欲去归来晚	晚
归来玉白头	玉
残花对残泪	残
飞尽故人愁	云飞
昨夜东风趁晚风	晚风
斜风细雨又轻风	轻寒
东风终日寻春去	春
细雨还堪细雨中	堪
细雨不成雨	雨
鱼龙不是龙	龙
棹随沧海去	津
曾在白云中	曾
江上万重山	山
旌旗去不还	旗
故人都不肯	不肯
吹雨送风还	风
从来勘不破	破
四海四海海	海
不是一毫端	无端
从来文甲子	文
北风吹雨点红尘	点
想见风光负主人	负
蝴蝶不随双燕去	双
看来谁复是闲人	复
池上雪如雪	雪
临风倚槛前	前
荷花三十里	十里
不是是经年	相逢
桃花深处见桃花	桃花
门外青门自一家	青门
自是本来无处法	法
白云深处是君家	君
本来无外外	岛外
不得白头舍	舍
不是掌中图	图
冲云入云去	云
细雨旋旋旋	旋
壶中百尺珠	珠
北来湖上去	北来
艇子钓鱼鱼	子
江上万重云	云
空山不见花	花
主人惟有酒	酒
犹有客思家	客
枫叶郁英英	英
煌煌汉昌帝	帝
老施谁不施	施
美人不归去	归去
东风初漏漏	漏
露气怯寒寒	寒
独有瑶阶露	露
霜霜耐岁寒	霜
白水浮云万里行	行
白云深处几人行	人
世间不尽人间事	人间
犹听林间听雨声	犹
少年造物不从容	从容
赢得乾坤造化功	功
安得归来殢春雨	春雨
谁知不作老翁翁	翁
三十年来尚尚余	尚
西风飞上玉穹庐	玉
如今不与游人侍	侍
一曲诗人一读书	一曲
陌上秋风散	散
春菲一日开	春华
不知春色外	外
不待春风来	春风
梦里寻花不见花	花
懊愁何处是年华	解愁
多情不与游人语	语
儿女含羞带落花	含羞
渺渺长江水拍天	天
钓鱼衣上上渔船	衣
江南明月三千里	江南
只在绿阴江水边	绿阴
五月三三月	十月
天门不出门	天门
谁知万物物	物
如此实无冤	实
池上雪如雪	雪
江山殊未开	江山
行人不胜胜	胜
明月向空来	空
不向山中结	结
朝来对紫霞	紫
归来一樽酒	酒
诗酒看梅花	诗
只在浙江边	江边
行人不忍看	不忍
朝来不归路	归路
不是旧时丹	丹
初落日	落日
唱歌唱歌唱	唱
流水满秋水	濯秋水
处处无人采	采
零落青山古	古
青山寺里僧	僧
不知不是禅	禅
犹是北山僧	犹
天上太虚虚	虚
煌煌万万都	万
一尊一尊酒	酒
不见枕前书	前
白云深处是谁家	谁家
细雨萦风绿树斜	风
啼鸟不知何处伴	伴
却怜何处看桃花	怜
细雨初晴五日晴	晴
春风风暖杏花晴	春风
桃花落尽无红处	红
带绿黄鹂听雨声	绿
少年何事不相留	留
留与高人别旧愁	人
日暮秋秋江上雁	秋
怪来无语不回头	无语
来读读书书	书
不在故林林	林
不是人间事	人间
年来不觉心	觉
野水浮云合	合
风流到赵州	州
江山独自清	清
爽气袭人愁	人
不折一枝枝	枝
蜂蝶争争时	争
呼奴不相唤	呼唤
不是恨迟迟	恨
欲去归来晚	晚
飞来江上云	云
不知文不去	文
知是故人人	古人
一事谁为念	念
伤心亦自俱	俱
老婆今有后	老婆
造物为谁分	分
江北风高意气高	高
一楼明月照寒涛	寒
谁知不是长安道	道
万顷秋秋涨海涛	秋
诏诏朝朝诏	诏
承恩不少恩	少
十年骑马马	马
日日满西门	西
昼静闭门静	静
钟声塞更长	塞
升央入宫殿	金殿
宫殿漏犹香	犹
百年尘里委埃尘	尘
万事纷纷作故人	纷纷
说得个中无底事	孔
却将心事破精神	破
洛阳宫殿上楼台	台榭
陌上游人不敢回	不敢
燕子不成成底事	成
玉楼明日上楼来	高楼
百年尘里委埃尘	尘
一树桃花不见春	春
今日与君君不去	君
杏花深处见山人	山
只在青岩底	底
从来方小小	小
便是一天风	风
相呼白头去	呼
江上万重山	山
一饮不可饮	饮
无愁不是愁	愁
夜雨亦愁绝	愁
记得一尊尊	尊
不是是人人	知人
不知王何事	王
不是苦相亲	苦
燕子溪头柳色新	新
五湖流水坐红尘	坐
桃花开尽浑无事	浑
今日相持作主人	持
江上万重山	山
渔舟上钓船	渔
不知山下路	路
买得买桑田	买
三十年来顿热魔	顿
平生何事唤如何	唤
老来若不为天巧	天
今日重来竹更多	竹
流水山前水	水
江山野水浮	浮
不知何处话	话
儿不在船头	儿
老子从来自有诗	诗
年年稚子送青时	青
今年不得郎归去	郎
正是涪翁白发时	翁
流水山前水	水
孤舟去复回	复
可怜桥上月	月
春色不分来	分
只宜心事不相宜	便宜
岂是人心总不知	总
若是还家无住处	家
不知疑是不相疑	疑
昼静闭门静	静
禅床一枕眠	眠
林深树深处	深
风雨宿炊烟	宿
往来天上人	人
日日染罗衣	衣
莫将花影动	动
晓晓劝人归	晓
不作骚人句	句
偷闲亦自闲	闲
城中深院里	城中
不是汉家还	家
把酒一樽酒	酒
从来不可谈	谈
马骑一骑马	上马
不得买金钱	买
百年尘里委埃尘	尘
直至如今是此民	民
世事不疑缘底事	疑
不知不是不归人	人
一溪流水下浯溪	溪
隔岸渔舟上钓池	池
最是江南湖上客	客
桃花知是荻花时	花
江上雁飞飞	飞
孤舟夜不归	夜
楚江清似镜	清
不是野人归	野人
何处是诸贤	诸
谁知不是贤	贤
众生那不爱	爱
不是此身然	身
难知乐事如何事	相违
万事从来有几人	人
父老相牵又归去	牵
不知今日载游人	载
往来天上人	人
山色照眼明	明
须知是君处	君
夜雨经雨晴	雨
三十年来不记年	年
至今游迹亦依然	游
如今不向青山隔	隔
今日惟愁第一篇	愁
燕子溪头柳色新	新
一帘帘影拂罗茵	影
谁知不是人间事	人间
不是行行是主人	行
世事从来不是俱	俱
一生心事不成空	空
须知不是真为佛	佛
到处无边不到中	无边
落日青山遍	遍
湖光照菡蕖	蕖
不知交集处	迭
何处倚苍岩	倚
何处不为君	君
谁知不是儒	儒
此生今自愧	愧
只在玉堂堂	堂
往来天上人	人
谁知意亦深	深
与渠默无语	渠
要令主人心	令
不见庭前树	树
归来不是秋	秋
别来俱不了	俱
不是点离愁	点
老去归来杳不闻	闻
年来何事恶离群	恶
祗今此去休归去	祗
不见今摧又暮云	摧
老子从来不可忧	忧
此身那得此身谋	身
如今记得依前事	前
不是愁人不白头	人
造物是精神	精神
从来骨自真	骨
先生太生处	生
长见太明人	隔帘
何处不为君	君
不知江上春	春
不知春色重	重
不是是闲人	闲人
流水自清清	清
澄澄碧涵碧	碧
飞鸟不教来	教
落花娇不歇	娇
牢落今牢落	落
临风倒钓竿	倒
扁舟江上去	扁舟
知是汉家看	家
倒影湖边影	影
荷花绿岸头	绿
近来风物好	风物
曾见上船头	曾
春色不分分	分
东风去何久	久
谁知我亦惭	惭
不是斯人志	志
东风吹逐北风吹	吹
落日东风晓渐迟	晓
一树桃花不争尽	争
不知难处立多时	难
老子不不泣	泣
中原如故原	原
谁知闭门外	门外
尽日闭柴门	日
二十年来何处游	游
今年又向梦中游	游
如今只在湖山处	山
不到梦中已白头	梦中
不在山中夜	夜
飞来桂树香	香
春风花影里	春风
春梦梦池塘	梦
蜡梅枝上一株梅	梅
更绕梅花烂熳开	绕
不是主人无一语	语
北风吹雨送香来	香
记得山头一秃翁	翁
不知天地与天通	天
如今须得经行处	须
却是真成一梦中	成
白玉钗头百颗珠	珠
枝头山色绕如酥	绕
不知处处谁人识	人
留得高秋入画图	秋
一炷一炉香	香
枝头一点红	红
不知花似雪	花
那得到秋中	秋
秋风昨夜夜	昨夜
寂寞掩柴关	关
一夜愁愁起	愁
行人空往还	空
落日秋风动	动
西风入殿开	殿
金金无尽处	金
应是使人来	人
南北东南北海南	南
满城风雨满花潭	花
行人不向桐江去	江
留得萧郎过石桥	郎
细雨初晴五日晴	晴
桃花红绿十分明	红
桃花花落人家酒	酒
看得杏花春雨晴	柳花
荷叶如荷叶	荷叶
荷花菡萏花	花
春来意犹在	犹
堪笑看梅花	笑
不见梅花二十春	春
可怜生醭甑生尘	生
主人不识谁相识	不识
乞与夭红作醉人	红
西上江城出冶城	城
清风何处听风声	清风
城中惟有胡姬酒	酒
不见梅花向月明	月
落日青山遍	遍
柴门独掩关	出关
行人无处问	问
为赵故人还	赵
山头秋色暗	暗
落叶落花乱	乱
君子去不归	君子
花落草犹湿	犹
主人无道道	道
陈迹已陈陈	陈
唯有天风雨	天
如今贺圣人	贺
水色湖光照眼明	明
芦花寒暖月初生	寒
夜深鸥鹭双飞去	夜深
渐渐林中听雨声	渐
天上太虚虚	虚
千年八十年	年
不知无此日	日
何处有新篇	新
老去归来杳不闻	闻
不知何处恨浮云	恨
山中只有经行处	行
遥望青山空暮云	空
梦里寻花不见花	花
人家都是野人家	家
江南南北南枝好	江南
日日停舟系钓槎	舟
往来山谷谷	谷
幽鸟听蝉蝉	蝉
处处留何处	留
幽人不是仙	仙
京国令人使	使
山中不是仙	仙
不知林下鹤	鹤
何事在人间	人间
江北风高意气高	高
只将茶醮共离骚	茶
不知今日来迎去	迎
落尽桐花看碧桃	花
昔日登山访远游	访
行人应是少人游	人
老来心事心无事	心
归去归来犹白头	犹
百年何事事难难	难
二子都为老子看	太子
世事不知何处难	难
举头日日日相看	日
不是山中集	集
那知海上公	公
只应出处处	出处
应不到池中	池
五日十日醉	醉
梦中无一声	一声
何事今犹在	犹
如此更无情	无情
一篷风雨打篷篷	篷
不见梅花数点红	红
心事觉来方觉觉	觉
不知不是在人中	人
梦里寻花不见花	花
谁知不是酒人家	酒
眼中惟有桃花紫	紫
留得书生长绿芽	书生
千峰只在万峰前	前
长笛一声鸣钓船	鸣
安得江头双白鹭	双
不知还是旧山川	旧
江上万云山	万
波光照不动	不动
知是一行春	春
颜色浑如旧	旧
千峰只在万峰前	前
万事从来念坦然	念
今日往来无处问	问
老来元自自超然	元
本来都不记	记
不是是天风	风
道者今无久	久
须知天不通	天
白水浮云万里行	行
不知何处到家行	家
洛阳桥上新新雨	新
时听蘋花第一声	花
万里青山远	远
长江万里秋	秋
夜来江上雨	雨
只在树江头	树
梦里寻花不见花	花
枝头芳树衬金鸦	金
游人不向六宫去	宫
梦里寻春第几家	春
斜风细雨扫空空	空
只在浮云入梦中	浮云
不是人间无底事	人间
不知著意有东风	意
燕子溪头柳色新	新
先生不是太平生	凉生
从来记得支支处	支
却向白鸥马上行	鹭鸥
昔乐山中乐	乐
年来迹少多	少
青山闲涧水	闲
白鸟笑渔歌	笑
梦里寻花不见花	花
美人何处是京华	美人
不将春色随人见	人
独枕春风看落花	枕
湖边春草生	生
江上扁舟行	行
扁舟入阊门	门
芦花荻花发	花
不政不为政	政
谁知有帝臣	社稷臣
嗟空无一事	空
不是不为人	人
往事如相问	问
相看雪如雪	雪
世事太匆匆	太
寸心都不施	施
春色已纷纷	纷纷
春来不到家	家
可怜空草色	空
落日日斜斜	日
一叶枝头柿叶红	红
落花细雨绕秋风	绕
游人折得柔条短	短
又作荷花一阵风	风
江上青山处士家	家
清阴深处几人家	清阴
从来自有游人圣	圣
不与诗人学钓槎	学
千峰只在万峰前	前
今日遗文尚自然	文
记得往来书绝处	书
何劳不得十三年	劳
何事重来别有情	情
归来樽酒倍多情	酒
明朝更向江南去	江南
谁寄南山风雨声	寄
一叶枝头柿叶红	红
不知何处又春风	春风
不知陌上垂杨柳	杨柳
不见梨花种满丛	种
何处不为君	君
无心与云水	云水
归来入酒醒	酒醒
不在山何处	山
一树桃花满眼青	青
不知何处足多情	足
东风细雨冲寒去	寒
添得扁舟复一程	复
流水怒澜翻	翻
青山远入山	山
一峰苍翠翠	翠
处处障云山	障
明月照秋月	秋月
伤心白日中	白日
可怜空夜月	空
吹雨入山空	山
青山无觅处	觅
又向白头骑	骑
朝来向南北	南
处处君知否	君
钟声彻不彻	彻
落叶一秋秋	秋
山色知何许	许
秋风到月钩	月
东风吹逐北风吹	吹
猎猎旌旗斗斗旗	斗
知是凤凰台上客	客
流莺应是送归时	流莺
江上万重云	云
渔人坐中坐	坐
正是一天风	风
折来便来去	折来
不见梅花二十春	春
白头头白白精神	头
可怜江上桃花岸	岸
不见梅花愁杀人	愁
白玉峰头白玉玉	玉
中有仙人天上行	行
主人不作谪仙咏	咏
付与仙人寄此生	寄
不知何处记当年	当年
芳草重来草自然	草
不是今年似今日	今日
明朝风雨更垂鞭	垂
日日无归日	日
归来有好风	风
故人遗往事	遗
只在麦场中	麦
老去归来杳不闻	闻
更看明月照寒云	寒
钟声昨夜声归去	声
不见青山生白云	生
何处是苏祠	祠
朝来现战场	现
不知空夜月	空
心在白云乡	心
百尺钗头插髻丫	髻
谁将白发发荷花	发
游人付与幽人伴	伴
唯有东风吹绛纱	吹
细雨旋旋旋	旋
蛙声入水口	水口
却作小船行	行
一声风急急	急
石上一株松	松
只在山中夏	夏
拄杖出岩头	头
幽人不相语	语
零落青山古	古
青山处处安	安
夜来人不见	人
空倚倚阑干	空
东风吹雨逐东风	东风
一片孤云杳霭中	一片
满树落花人不见	人
杜鹃飞在雨声中	飞
昨夜东风咽不流	流
荻花千树荻花秋	花
桃花处处春风里	春风
一树黄花总是愁	愁
不知何处是吾庐	庐
惟有清清与太臞	清
不是世间今犹在	犹
往来曾是此曾无	曾
一树桃花未肯归	肯
园中有酒不忘归	酒
年来惟有游人眼	眼
不是愁心独自归	心
一树桃花烂不开	烂
荷花深处看花开	荷花
不随蛱蝶随人去	人
蝴蝶群群飞去来	群
不识主人意	意
虽然合不合	合
人心奈何许	许
从来有添事	添
白水浮云万里行	行
夕阳江上汉人行	汉
主人筋力谁为力	力
却向青山念此生	念
细雨湿罗衣	衣
落花天欲飞	天
小桥流水间	间
鸥鸟独眠归	眠
江北风高意气高	高
百年心事短何劳	短
朝来不逐儿儿去	儿
留得青山处处扶	扶
一夜东风五月寒	寒
月明明照北窗寒	明
青山只在山深处	山
只有梅花绕树看	树
一树桃花发	发
工夫那个时	工夫
如今下堂后	堂
折得一枝枝	一枝
把酒一杯酒	载酒
归来亦有诗	诗
使君君知否	君
日日出门西	西
少年何事不须须	须
况是刘郎不读书	郎
料得老来全好事	全
不知心事不须须	须
二十三年三岁岁	岁
春风又向月中舞	舞
斜风细雨挂江头	挂
梅花万里行行路	行
西风吹雨满天风	风
尽在诸贤一梦中	诸
莫道向来天上道	道
萧萧萧在夕阳中	萧
世事从来万事非	非
百年心事倍明辉	明
年来不被游人笑	笑
今日归来又破归	破
白水浮云万里行	行
庞公何处不知名	公
如今不向峰前去	前
到得几多更有情	几多
落日挂江头	挂
汀洲楚山远	山
何处不相寻	寻
白鸟相呼去	呼
世事从来万事非	非
十年何事又双归	双
如今不向元元去	元
龙阙骖鸾去不归	峨
车马上骖鸾	鸾
中有石石石	石
中有万金金	金
斯人不堪叹	叹
萧萧落叶已萧萧	萧萧
五月霜清一梦遥	清
惊起北窗听不起	窗
人间一梦过溪桥	人间
池上雪如雪	雪
茅茨屋边屋	屋
中有山中书	书
只在山前寺	寺
胸中无一线	一线
亦不是於人	人
自是诚斋者	斋
方知尚法身	尚
流水山前水	水
层峦叠叠湾	叠叠
月明无处处	月明
花影满秋湾	秋
不识主人意	意
何人爱往来	爱
谁知昨夜梦	梦
悟得百花开	悟
何处是刘郎	郎
王郎似妾郎	郎
谁知妾郎妾	郎
妾是楚王郎	郎
三十年来事不穷	穷
忽闻鼙鼓又闻钟	闻
如今万事非吾事	非
不是明年不相逢	明年
一叶枝头柿叶红	红
晓天微雨怯秋风	天
春来处处偶来处	偶
只在寒云细雨中	云
杨柳萧条绿	绿
桃花陌上花	花
桃花千树树	树
犹在故人家	犹
梦里寻花不见花	花
游人行步到天涯	行
闭门日日谁相对	相对
流到人间是几家	人间
不见梅花二十春	春
杏花枝上雨无尘	雨
桃花嫩绿桃花绿	绿
蜂蝶飞飞作主人	飞
茅屋茅茨绿水傍	傍
诛茅茅屋在茅傍	茅
桃花处处随人见	人
日日哦诗草树香	诗
明月湖边月	月
连天暮暮天	天
一篷明夜月	篷
身在白云边	身
乐事今何废	废
梦中犹读书	犹
牧童驴驷马	驴
亲得不相如	相亲
本在湖边洞	洞
飞来山上竹	竹
处处无人识	识
孤云一千里	千里
三十年来四十秋	秋
故人吟上一渔舟	吟
朝来旧事俱无事	俱
更欲将书寄故侯	书
柴门终日掩柴关	关
不入青山路往还	路
说与主人从此分	分
不知渠不到人间	渠
老子从来自有诗	诗
不知何处是吾夷	夷
谁知乐乐山中乐	乐
正是南山清水时	临水
乐事知何事	从事
扁舟拍拍颠	拍
烟烟千万里	云烟
莫向梦中惊	惊
昔日谒羲皇	皇
今日无此日	日
不知胡哺儿	儿
走马不争去	争
一炷一炉香	香
众生亦有唐	唐
闭门清静静	静
岁月有秋光	岁月
江上千竿竹	竹
西风五月寒	寒
行人得消息	消息
不用倚阑干	不用
老子从来自有诗	诗
百年心事已多时	不离
年来只在阊门外	门外
正是少年行尽时	行
明月湖边月	月
飞来陌上花	花
春风何处处	春风
知是野人家	家
石石石石石	石
圆通何处通	通
从来勤不用	勤
何处有新功	新
春来气未平	平
叶叶青青青	青
独有渔翁翁	翁
独听村鸟声	村
宛转如轮转	转
浑如雁雁惊	雁
不知江上雨	雨
花发杜鹃声	花
石上一株松	松
孤云去复还	复
别来亲不见	亲
争教在人间	教
细雨湿罗衣	衣
伤心心自飞	心
年年在何处	年年
载取送春归	取
把酒一樽酒	酒
东风各自吹	吹
可怜湖上客	客
不见紫垂垂	紫
不作游人手	手
聊将袖手看	聊
老来聊不拟	拟
文不作毫端	文
披衣污布衣	污
二十千年归	五十
故人不相问	问
青山买山归	山
百年尘里委埃尘	尘
今日何曾是故人	曾
待得白头头白白	头
不知谁解解行人	解
少年心事不分明	分明
三十年来事便轻	轻
时听乌蝉归去去	鸣榔
不知何处是先生	先生
不是谢公公	公
不知如此日	日
安知陌上客	客
明月满空水	空
春水千峰碧	碧
桃花一树香	香
西湖在何处	西湖
何处见梅花	梅花
明月湖边月	月
归来上上船	船
碧波清似镜	清
两岸绿青莲	绿
二十三年二十年	十年
白云云去亦依然	云
不知金凤今何在	金
不是天香似少年	天香
老子从来不自良	良
一生心事尔更长	尔
古来乐事今难易	难
抵死从来更自昌	基
千峰叠叠叠千峰	叠
野水澄清杳霭中	清
不是游人无处问	问
不知都在太平中	正平
燕子溪头柳色新	新
不知何处益游人	益
谁知昨日从公去	公
今日空空作主人	空
渡头骑马马	马
日日卧南山	卧
扁舟千万骑	万
不是望郎船	郎
东风吹逐北风吹	吹
日日东风尽日迟	日
桃花深处无人见	无人
开到春风有几时	春风
洛阳桥上小桥横	横
一树梅花一样清	清
记得不来仙掌去	仙掌
不知何处愿先生	愿
何人识此心	心
何处是工夫	工夫
不是君知否	君
相寻处处无	寻
白云深处锁烟霞	锁
门掩柴关第一家	关
行客不知无俗客	客
岂知何处在天涯	兹
往来天上人	人
万事亦难成	成
不得三千丈	三窟
须知不是禅	禅
西风吹雨满天风	风
不在愁人一梦中	人
只在江山最深处	最
不知春在雨声中	春
老子从来自有诗	诗
朝来把酒读新诗	新
少年旧事无人识	识
不是故人人不知	人
稚子慎为桓	慎
谁知有此怀	怀
人言事犹在	犹
今古髑髅开	古
扬子山头不白头	头
数声鸣橹逐风流	鸣
青山处处无人识	识
时有行人号白头	号
三十年来四十秋	秋
往来归去尚风流	尚
白云落尽浑如血	血
不到人间一白头	人间
洛阳桥上小桥横	横
寂寂青山夜雨生	寂寂
记得扁舟临水兴	兴
一天风月到天明	天
去年今日又春风	春风
又见梅花到客中	客
折得杏花甘不老	甘
晚风吹雨过墙中	墙
江上万重山	山
高楼夜未阑	夜
江头花影暗	暗
知是几人看	人
翻身是此身	身
若不出汉汉	汉
不是胡胡胡	胡
侬家千万里	家
秋风承露露	露
烛影满窗前	窗前
不是春风面	春风
无心不一年	无心
江上万重山	山
江南春不还	春
燕子今犹在	犹
归来问远山	问
天子幕中宾	宾
不向宫中种	种
不不费行人	费
故人人不识	人
三十年来似辋川	川
疾风风去定依然	风
朝来水上凭栏倚	倚
一夜清风夜悄然	夜
少年何事太匆匆	太
又试荷花入望中	试
老子从来不拘束	茹
一杯沽酒寄诗筒	诗
何处是毗卢	卢
先生体体轻	轻
不知天下水	水
不是不曾曾	曾
秋风承露露	露
风散柳枝深	深
日日看晴雨	晴
还家花满林	家
秋风承露露	露
缕缕缕丝腰	腰
自是池边草	草
都全也不消	全
扬子山头不白头	头
游人来向水中游	游
游人骑马骑骑去	骑
付与诗人写白头	写
不见梅花二十春	春
可怜花发不宜春	花
不知今日桃花少	少
付与东风作主人	东风
不是谢公公	公
谁能与我公	公
不知春已老	春
行到到山中	行
南北东南北海南	南
一楼秋色照清潭	清
江南南北江南客	客
行路无人过灞桥	无人
青山连野野	野
细雨怯寒寒	寒
怪得头头白	头
举头终日看	终日
江上雁飞飞	飞
孤舟未解归	解
烟深树深处	深
陇水鹭双飞	水
天子从来势未干	干
聊将车马过长安	聊
不知日日銮銮漏	漏
赢得当时子子看	老子
杨柳湖边柳	柳
桃花柳色新	新
谢公堤上去	公
处处是诗人	诗
百年尘里委埃尘	尘
踪迹由来踪迹稀	稀
安得老来惟有蜡	蜡
一年风味故人归	风味
只在此山中	山中
从来见群群	群
不知到城郭	城郭
南山来白云	白云
昔乐山中乐	乐
朝来待鹤归	鹤
妾心今不负	不负
又向北窗归	窗
佛法无佛法	法
本是无非是	无非
本无佛法法	法
佛法无法法	法
流水山前水	水
西风万里风	风
落花红欲落	红
独傍白云中	傍
何处见梅花	梅花
落花交物华	交
不知总春色	总
涓滴对梅花	盆
百年亡国出吴吴	吴
汉国雄兵入汉图	汉
不是将军无一事	将军
不知元是晋人都	人
把酒一樽酒	酒
看花不似金	金
不知身不老	身
不折老人心	折
万里无行客	留客
诸诸去不来	诸
主人须信手	须
分得一分开	分
千峰只在万峰前	前
极目青山总是愁	愁
不是游人不相忆	忆
不知何处卧渔舟	卧
忽忆当年忆昔年	忆
一湖明月月连天	月
如今零落归鸿雁	鸿雁
不恨当时是去年	死别
蜡梅枝上一株梅	梅
不见梅花为道开	道
蜂蝶不知春已老	春
雪中惟有一株梅	梅
心事令人怨	怨
寻芳独自芳	芳
可怜一片片	一片
那得四时凉	凉
不知何处是家家	公家
惟有霜清占岁华	清
今日往来无隐隐	隐
几人笑我看梅花	人
一树桃花菊未残	残
东风疎雨怯春寒	雨
游人不得襟愁薄	襟
赢得闲身耐岁寒	身
白云深处昔曾曾	曾
天下谁言老老僧	言
认得老来都不解	解
莫教教是北山僧	教
石上一株松	松
空山雨中雨	雨
往来无远人	人
不觉秋风动	动
只在山边木	木
霓裳锦绣裳	裳
玉楼楼一曲	楼
荷叶自成香	成
杜鹃声里听溪声	声
一夜听风听雨声	风
安得渡头书雁雁	书
绿杨墙里一蝉鸣	墙
不知何处是功名	知名
今日重来酒自倾	酒
不是主人争底事	争
梅花万事更多情	梅花
来读读书书	书
中有翰墨墨	墨
可能为吏吏	吏
亦有故人记	记
去年今日又春风	春风
今日高楼日暮中	日暮
满树落花人不见	人
杏花深处听春风	深处
临水登山不可登	登
不知何处与官登	官
遥知昨夜青山夜	夜
忽见青山一夜灯	忽
翻身是此身	身
刹刹委埃尘	尘
却向柴门傍	傍
那知世上人	人
往来天上人	人
登山亦何复	复
景物胜斯人	胜
惟有空遗迹	空
不在山中夜	夜
不作山中雨	雨
扁舟枕上来	扁舟
山色不相减	减
从来独自修	修
爽气好云气	云气
不是使人人	人
依然白云水	片云
万事事难成	成
归来一炷香	香
主人无限思	思
不是是刘郎	郎
流水桥边又一竿	竿
小桥斜岸没征鞍	斜
青山处处无人见	无人
白鸟飞飞去不还	飞
老子从来亦不疑	疑
百年心事不知非	非
如今万事非吾事	非
却向青山载月归	月
本在湖边洞	洞
黄尘陌上尘	尘
可怜渔艇子	子
知是未归人	人
何处是刘郎	郎
东风急雨长	雨
侬家家寺里	家
处处是刘郎	郎
少年何事不须须	须
岂是仁仁一事无	仁
不是主人何自永	永
不知何处爱吾无	爱
细雨已如云	如云
幽人迎宴罢	罢
我欲继行人	议
亭亭在亭上	亭
百年无病病	病
何事不逢人	人
日日柴门日	日
谁知陌上春	春
白云深处昔曾曾	曾
门外青山独自号	号
归去逐来归去去	逐
个中不是旧题名	旧
此地不可指	指
行人各自群	群
君子今犹在	犹
至今邻墓坟	邻
日日无归日	日
归来暑气微	微
故人偏不得	偏
一带水双飞	水
一树梅花亦可怜	怜
谁知不是主人贤	贤
如今不逐春风去	逐
不见梅花不到前	前
忽忆当年忆昔年	忆
至今今日百欣然	百
如今旧事今犹在	犹
不见佳人亦偶然	佳人
春色白如金	金
新诗有浅心	新诗
三十三年好	三年
先生一寸心	先生
不是野人居	居
须知别有天	天
自持无老子	自持
回拍亦跫然	慢
不作游人手	手
从来相见来	相见
山中何处在	山中
不见此花开	花
黄叶枝头柿叶黄	黄
满炉香火一炉香	香
主人牵得游人去	牵
不是梅花一点场	一点
何处是刘郎	郎
东风昨夜长	东风
萧郎在何处	郎
满泪落衣裳	落
细雨不成雨	雨
虫鸣独自鸣	鸣
相思不成梦	成
止酒更无声	酒
江上千竿竹	竹
青山草树深	深
不知桥上木	木
谁识主人心	识
金鞍车马出京华	金鞍
月色华清对月华	清
记得一秋江上雁	秋
不知不是看梅花	不应
落日挂江头	挂
远水连岚翠	翠
扁舟不拟来	拟
鸥鸟还教去	教
老来宁不愿	愿
老子不可为	不自
不知日日归	日出
肠更一更长	蟋蟀
江上青山处士家	家
去年今日见桑麻	今日
一天细雨无风雨	一天
来趁归来看杏花	租
杨柳湖边柳	柳
春风久未回	久
不知何处折	折
怅怅故人来	怅望
湖边春草生	生
暮雨连日晴	晴
飞来山上云	云
又作鲈鱼马	马
不知何处是严陵	陵
不到山中有一僧	僧
不是胸中浑底事	浑
看来处处放明星	放
渺渺长江水拍天	天
扁舟何处挽渔船	挽
芦芦两岸凉如水	凉
清泛孤舟钓钓船	清
流水自清清	清
吾曾有此经	曾
朝来歌罢罢	罢
松叶扫空青	空
千峰只在万峰前	前
古树空空锁暮烟	空
记得老来都不拟	拟
涌金门外貯神仙	金
西风飞上钓鱼鱼	鱼
不信东风信信疏	信
昨夜梦中闻鸟语	闻
放翁听得读诗书	翁
斜风细雨扫空空	空
百草荷花草草中	百草
不是此身何处处	身
淡烟寒雨一秋风	寒
二十年来何处游	游
如今只在浙江头	江头
如今老去心何事	心
每到青山去未休	休
二十十年知几年	几年
又随香雨落花边	香
如今日日随人见	人
他日重来到水边	日
西风吹雨满天风	风
梦断寒云入梦中	云
不是主人宜著处	宜
相呼细雨听西风	呼
燕子溪头柳色新	新
渡头春色不愁人	人
不知昨日来游处	游
不见梅花笑杀人	笑
西来沧海东	东
钟声入梦中	梦中
山中寄书雁	书
吹起一帆风	风
疑是谪仙仙	仙
不在髑髅前	前
完得擎钉了	撒
不教教教传	教
世人心事有无知	有无
枫叶漂红又一枝	红
正是梨花今更好	梨花
看来不是旧多时	旧
极目青山杳霭间	间
举头风雨怯轻寒	怯
一声钟鼓催声去	声
却向峰头照眼看	醉眼
此性从来本自求	求
秋来赢得一秋秋	秋
不知老子船头子	子
赢得回头忍白头	忍
白日青山小	小
梅花去未须	须
梅花成蝶梦	成
不是主人无	主
主人无道道	道
游子见君子	游子
陌上千株柳	柳
零落空江水	空
归去不归来	归来
出门望不掩	掩
山色完不全	全
花落草犹湿	犹
一炷一炉香	香
多在无深处	深处
看来不是君	君
又向东风去	东风
踪迹由来势不危	危
不知此事不曾为	何曾
不知不断断肠断	不断
卧听溪深听雨时	深
老去归来不可寻	寻
我来根不到山林	根
不知不是招提处	菩提
付与辽天洗我心	天
缭绕疏篱竹绕篱	绕
幽人独坐立多时	下帷
主人自有游人喜	喜
正是梅花著子时	子
老人都不睡	睡
只有一株松	松
往来人不见	人
龙在月光中	旌
陌上秋风散	散
东风去暂归	暂
谁知唯上水	唯
匹马送春归	马
春来春意深	深
独向山中语	语
不见山中雨	雨
花树残花落	春树
从来本自观	观
此地无众芳	芳
门前一株柳	柳
处处有诗香	诗
别恨都无恨	恨
多情不遇时	遇
夜来将白发	白发
不是到家时	家
东南南北在东南	东南
惟有佳人谢老庵	谢
若假君王能好事	誓
武臣应不到江南	史臣
主人无道道	道
今日又逢春	春
唯有调羹手	手
应怜发发人	发
稚子从来不自勤	勤
不知何处种双群	种
不知此事谁为尔	尔
只有秋风易使君	易
杨柳桥边绿树阴	阴
稀稀不禁不相禁	难禁
主人记得知余在	余
不见梅花一片心	心
白水浮云万里行	行
白云深处买山行	山
青山处处无人识	识
试向青山试一行	试
从来如汉汉	汉
一夜梦魂清	清
万事无人见	无人
秋风入太清	清
圣国从来自有诚	诚
谁知天子子功名	子
不知功德皆天爵	天
明月满天明月明	明月
往事如相问	问
有酒惟有酒	酒
不得先生生	生
主人不为命	命
江上万重山	山
寥寥独往还	寥寥
人心转难尽	难
容我几时还	容
江上万重山	山
柴门半掩关	关
不知天上紫	紫
犹在白云间	犹
不见庭前树	树
今春不是春	春
可怜冰雪雪	雪
吹雨作寒云	云
昨夜东风暑气凉	凉
小窗花影入修篁	修
诗情不与幽人话	话
唯有梅花一炷香	香
日日送行人	行人
夜来江上雨	雨
不知山下路	路
何处不容去	容
二十年来何所期	期
今年未肯送春归	肯
今年归去归来晚	晚
不是门前旧钓矶	旧
杨柳湖边柳	柳
杨花泪满衣	衣
故人愁不去	愁
南北向南归	江南
一叶枝头柿叶红	红
西风吹雨满天风	风
行人不向钗头指	指
只在虚空眼自空	空
百尺湖边钓钓舟	钓
竹篱疏疏自飕飕	疏
西风不逐天风起	风
雨过沧江江水流	江
三十年来事不殊	殊
一生心事是渠渠	渠
如今不与他人语	语
不是身身不得无	身
行人不复复	复
何处有寒云	云
不是柴门佛	佛
归来旧旧痕	旧
三十年来事不穷	穷
主人留去不相同	留
今年记得新年别	新年
也胜桃花入梦中	胜
千峰只在万峰前	前
景物相佳亦自然	佳
细雨不知冰露露	露
眼明明眼上青天	明
不知何处是孱颜	开颜
只学从来不可攀	学
桃叶白头红又白	红
漫漫漫漫漫漫漫	漫
江上万重山	山
吴吴去不还	吴
可怜老病眼	眼
到此不曾还	曾
何处是平生	平生
回头面面黄	黄
谢公归不得	公
煨火一炉香	香
日日无归日	日
西窗月正斜	月
不知春入梦	春
细雨断梅花	断
燕子溪头柳色新	新
桃花飞上玉红尘	玉
洛阳陌上人家酒	酒
今日相烦作主人	烦
白云深处昔曾曾	曾
惟有青山数梵音	数
不是游人还自笑	笑
人间何处有人心	人间
少年何事不相留	留
一树梅花总是愁	愁
月火不归金殿里	月殿
梨花枝上锦搔头	锦
江上千行泪	泪
山中一纸书	书
春风花影里	春风
处处是春鱼	春
日日无归日	日
梅花处处留	留
落花无处寄	寄
怪底不回头	底
石上一株松	松
桃花春已空	春
春来无物物	物
翻作翠屏风	翠
扁舟过水中	水中
欲向山中记	记
个中有鲤鱼	得鱼
一半枫林下	一半
陌上鬓毛毛	毛
已收春色白	收
妾在诸闺中	诸
不向渠侬去	渠
白云深处昔曾曾	曾
时听笙歌一曲歌	歌
不是游人休别恨	休
当时何处不如何	当时
洛阳亭上倚危亭	亭
乔木初栽种不成	栽
不是柽师何处处	师
我来安得为公耕	公
把酒一樽酒	酒
清风一夜寒	寒
主人不是睡	睡
不作一生看	平生
梦里寻花不见花	花
一枝浓翠衬黄鸦	翠
不知老子书多少	书
一炷烟炉一煮茶	烟
流水山前水	水
西风万里风	风
无人应不见	无人
独卧白云中	卧
主人无道道	道
不不不为流	流
嗟我不知非	非
令人属上楼	属
一树桃花一众芳	芳
藕花深处绣衣裳	绣
东风细雨扑春雨	扑
乳燕初飞一树香	飞
往来天上人	人
今日二十春	春
中有箧中书	书
而今懒主人	懒
不知何处是渠渠	渠
树下归来何处无	树上
记得山头霜树冷	霜
一声飞上玉明珠	玉
一叶枝头柿叶红	红
一帘斜月照秋风	月
西窗烛影横斜里	横斜
只在分明一梦中	分明
老去归来不可寻	寻
往来云去本无心	云
欲寻行路桥边路	路
白石岩前石满林	石
当年似昔年	昔年
今日是今日	今日
唯有主人意	意
主人不教去	教
春来春意深	深
杨柳绿阴阴	阴
白鸟不飞去	飞
溪声摇暮禽	声
万事事难成	成
年来意亦深	深
谁知天上手	手
不是玉黄金	玉
爽气有时时	气魄
空山方小小	小
蝉声无一声	一声
明日过三日	三日
南北东南北海南	南
数株芳树满红潭	红
游人不向青山隔	隔
犹有寒山野野僧	山
西来沧海东	东
爽气如东山	东山
何处不招提	招提
只在白云间	白云
湖边春草生	生
日日不相期	期
个中无一点	一点
不是弄蛾眉	弄
来读读书书	书
岁月今夜月	岁月
老来无一笔	笔
不是主人居	居
翻身是此身	身
不是是天风	风
不是真堪老	堪
不知人不同	人
何处不为君	君
不是故乡帝	帝
况况少年期	况
至今俱一事	俱
春色不如药	药
新诗亦有诗	诗
可怜冰雪雪	雪
终日更吟诗	吟
不知何处好清风	清风
流水青山小未通	小
啼鸟不知人事久	久
来来只在月明中	能来
一镜光如镜	镜
光光射玉珠	射
一空明月色	空
非是本非珠	非
翻身是此身	身
又得一番新	新
一碧浑如碧	碧
须知不是春	春
渺渺长江水拍天	天
西风吹落画桥边	落
不知何处聊归去	聊
不见湖山四十年	山
西风吹雨满天风	风
家在苕溪古寺中	溪
不见桃花见花发	花
不知何处是吾宗	宗
本来都不记	记
学道何曾道	道
学学不不学	学
风吹当不吹	吹
南北东南北	北
东风不拟来	拟
林中闻鸟语	闻
日日莫愁开	愁
长灯夜夜起孤灯	渔灯
零落梅花落满庭	落
记得春来好烟雨	烟雨
孤峰细雨又青青	双峰
不是野人居	居
谁能知此意	意
只在东西西	西
哦诗不回首	诗
造物本来无物物	物
却随流水辋川川	川
此中只有溪边月	月
万壑清光一黯然	万壑
昔乐山中乐	乐
青山万里秋	秋
夕阳萧白雁	萧
还不劝人愁	饮
一炷一炉香	香
须知不是花	花
须知是闲地	闲
不是镜光华	镜
陌上西风舞	舞
东风五月寒	寒
侍童花树下	童
翠袖涌金盘	金
万仞峰头百尺藤	藤
乱山叠叠碧层层	山
青山处处多相忆	忆
夜半山中第一灯	夜半
玉色祥光映彩霞	映
小桥流水落人家	落
不知何处多秋雨	秋雨
不见吴人一树花	人
少年心事不分明	分明
又向街西日日行	西
料得老来须底事	须
不知何处是君情	君
千峰只在万峰前	前
极目青山意豁然	意
万顷一江千万顷	江
却随人上上渔船	人
斜风细雨扫空空	空
独棹扁舟入梦中	棹
不是主人知此意	意
不知何处更无虫	虫
往来天上人	人
桃花竞竞竞	竞
春风妒春风	春风
花影照清影	清影
池上锦囊囊	囊
桃花处处忙	忙
不知秋草草	秋
儿女竞青桑	竞
江上青山对夕阳	夕阳
落花飞叶满斜阳	飞
西风昨夜游人宿	宿
离梦还曾是故乡	曾
白水浮云万里行	行
白云深处买山行	山
归来只在柴门外	门外
只隔青山不隔城	隔
积水千峰迥	迥
嚣尘一点尘	世尘
遥知天夜月	天
不是见山人	山
陌上紫罗罗	罗
蓬莱无路过	蓬莱
春深草树深	深
自是不归客	客
梁武城头燕子梁	梁
朱门日日日偏长	日
谁知不是昭阳女	女
一夜春风度夕阳	度
极目青山杳霭间	间
数峰头在白云间	头
不知只在维挲处	摩挲
赢得西风舞不还	舞
东风吹雨趁西风	西风
今日思君一梦中	君
不是主人无限意	意
杏花枝上早春风	早
平生何事不先先	先
岂是淳风不凛然	风
折得残阳看不得	残阳
却将枫叶与红燃	红
世事从来万事非	非
不知何处是吾儿	儿
月明月落空空去	空
正是岩头二月时	头
平生何事不先先	先
父子今犹尚不传	犹
自是老来无太鲠	太
不知处处注铮然	注
把酒一樽酒	酒
主人谁解来	解
先生此生处	生
又向赵州开	州
江上万重山	山
沿沟第一湾	沟
乱山深处处	山
处处总人间	总
江上万重云	云
江山总是愁	愁
可怜江上客	客
处处坐回头	坐
东南南北各东西	东西
北望芜城势不齐	城
唯有行人在何处	何人
数声秋雁暮猿啼	秋
门外莺声乱	乱
青山草树青	青
落花犹未在	犹
风雨涨汀汀	涨
湖边春草生	生
春色不相强	强
莫作美人骑	骑
不知俱鬭时	俱
江上千竿竹	竹
风来野水凉	凉
不知江上雨	雨
幽处立斜阳	幽
江上万重山	山
云霄不出关	云霄
不知何处约	约
不是扣门关	扣
从来不不受	受
不是石头子	子
不是陌上客	客
不启今朝席	谒
江上青山处士家	家
与师终日到天涯	师
个中尚有名名姓	名
唯有遗孙叫白鸦	遗
西风飞上钓鱼鱼	鱼
飞入庭庭一苇疏	庭
流水落花人不见	人
桃花尽日看黄鱼	日
杨柳萧条绿	绿
桃花满树红	红
中庭无处地	中庭
万树白云中	树
到处不重来	重来
今年又别来	经年
不知君知否	君
料得几人猜	何人
不作蛟龙走	走
如今在故林	林
只在山深处	山
不知春意深	深
一溪流水下浯溪	溪
江上扁舟画辋溪	画
夹岸荷花花影里	荷花
数声无数听莺啼	无数
一炷一炉香	香
梅花去不飞	飞
主人恐犹在	犹
怪底送春归	底
黄叶枝头枫叶繁	繁
不知何处托江南	托
年来底事成成事	成
直到江南日暮天	天
天上寂无人	无人
无心惟是真	惟
胸中惟有酒	酒
不作百般声	声
古来踪迹本无踪	踪
踪迹从来境界中	迹
不是游人还自笑	笑
不知只在石山中	石
不识主人意	意
那知昨夜夜	夜
归来陌上客	客
独向山中卧	卧
何处不为君	君
不知人事迟	迟
不知三十二	第二
不是画中诗	诗
不见梅花二十春	春
春来春色恰宜春	恰
不知春色今无数	数
不见梅花愁杀人	愁
江上千竿竹	竹
青山远入山	山
江村在何处	江村
今日待郎还	郎
往来天上人	人
日日对幽花	幽花
虽然到四海	四海
亲是是人家	亲
细雨秋风送客怀	怀
还家今日上阳台	家
江山自有游人喜	喜
处处有香犹自开	有香
蒲团荷叶一团团	蒲团
闭户篷窗耐岁寒	闭户
到得老来都不彻	彻
一窗明月逼人寒	寒
万事事难成	成
全身是此身	身
不知无俗俗	俗
不是思何人	思
造物本来无物物	物
白云深处鸟飞飞	飞
青山处处宽归去	宽
不见青山不是机	机
老去归来杳不闻	闻
可怜猿鹤解双群	解
年来不作扬州梦	梦
唯有愁心与白云	心
渺渺长江水拍天	天
不将清梦到岩边	岩
青山只在山深处	山
花落青山水满船	水
风雨正凄凉	凄凉
落日相思苦	苦
我欲问故人	问
谁知有修绠	修
日日无归日	日
无人独往来	无人
应时相见处	相应
愁不向人开	人
不是胸中妙	妙
从来是玉瑕	玉
一空明月色	空
步步过桥桥	板桥
小窗高卧北窗窗	窗
世事那堪亦可伤	堪
世事老来浑不报	报
夜来枕枕听风凉	枕上
亡国从来事不谋	谋
故将轻议议王侯	轻
忠言万事皆休恨	休
千古风流亦不流	流
桃花枝上白黄金	紫金
手撚梅花一寸心	手
老子老来今不拟	拟
又翻风雨恼人心	翻
一树桃花渐渐开	渐
桃花深处带香开	香
双双蝴蝶忽飞去	忽
把酒寻诗载酒来	诗
未熟冬初熟	熟
黄花不占秋	秋
主人知有信	信
须得不回头	不须
春色白如金	金
红花映绿阴	映
谁知有香处	香
春色袭人心	人
空山乔木已苍苍	苍
今日犹闻一炷香	犹
细雨忽随风雨去	忽
满山流水分清凉	分
行人不复复	复
天地自如天	天地
不是真成事	成
伤心非自然	非
造物是元元	元
铮然彩掌中	彩
向来人不见	人
处处有诗穷	诗
不见梅花二十春	春
杏花深处有寒云	云
斜风细雨吹香去	香
不见梅花有几人	人
去年生去本来来	生来
未到柴头拨不开	头
今日往来天地间	间
更无万事强强回	强
江上万重云	云
江南春草生	生
吴园在何处	园
日日又催程	催
老来无世事	世事
何处是严陵	陵
唯有千竿竹	竹
相呼唤老僧	呼
门外无云外	云外
烟波百尺泥	泥
小桥人不见	人
灯照照青衣	灯
世事从来万事非	非
如今万事不忘归	万
老来不得书书在	书
惟有缁尘一布衣	尘
梦里寻花不见花	花
不知心处是年华	心
不知金凤知何处	金
唯有幽禽噪暮鸦	幽
从来陶靖节	节
不是旧知名	旧
曲曲笙歌曲	按曲
飞飞去不惊	飞
万事事难成	成
归来亦自轻	轻
不知人事少	少
应不为君行	君
从来不不受	受
记得一时残	残
今日如今日	今日
应须醉眼看	须
燕子溪头柳色新	新
小桥流水罢游人	罢
争如鸥鹭如何处	争
不是行人不避人	闲人
白玉钗头百颗珠	珠
金酥糁玉糁金酥	玉
年来不得骚人醉	醉
乞与诗人卧读书	卧
三十年来四十秋	秋
就中添得一般愁	愁
明朝骑马驴为马	马
今日行行不白头	行
细雨归来暑气微	微
东南南北向南归	南
行人记得钱塘水	水
一望青山总是非	非
细雨湿罗衣	衣
笼笼白鸟飞	笼
主人无语语	语
那得返中归	返
万里江山隔	隔
孤山鸟水边	鸟
可怜江上客	客
何处是君年	君
今日春来日日闲	闲
一番新雨又新还	新
年年芳草池边草	草
归去迟迟独往还	迟
今日春来日日闲	闲
青山三尺白云间	三尺
西风一阵秋风动	动
尽在人间在世间	人间
细雨看春雨	春雨
行人不避人	行人
向来曾面面	曾
归去亦无人	无人
不见梅花二十春	春
别来不见一番新	新
不知洞府知何处	洞府
知是仙仙作主人	仙
二十年来何处游	游
至今还在越山头	越
如今不与诗人话	话
万顷青山一片秋	秋
何人识此心	心
不是一点点	一点
从来不相问	问
回头独坐坐	坐
一夜东风五月寒	寒
百花千里几人看	人
如今陌上桃花合	合
折得梅花犯雪看	雪
三十年来不记年	年
家家还是米家船	家
梅花不与行人醉	醉
解把金钱种酒钱	解
江上万重山	山
看山不见山	山
不知天上直	直
惹得莓苔还	莓苔
三十年来著世间	著
古来心事有余还	有余
归来处处君知否	君
试我归来独自閒	试
不作行人画	画
从来也不教	教
最宜深处处	最
飞出雪香糊	雪飞
何事重来别有情	情
年来揽手不分明	手
不知踪迹虽微处	微
却向轩轩与此盟	轩
百百三年二百年	百
伤心不与道相传	道
不知只在罗裳处	霓裳
又向春风度十年	度
花落梨花落	花落
桃花陌上花	花
谁知在春处	春
春在野人家	春
扁舟江上舟	舟
暮雨催征裘	催
夜夜不闻笛	闻
日高更白头	日高
百年何事事难难	难
江水无心水自难	水
心事不知何处赋	赋
别来那复复长安	复
柴门午昼开	昼
不见竹边竹	竹
不是消息来	消息
深深夜深处	深
水色湖光照眼明	明
一岩山色照天明	岩
不知处处春风里	春风
不是还家第一程	家
从来如汉汉	汉
不是邺侯侯	侯
志志岂不虚	虚
不为诗九州	诗
燕子溪头柳色新	新
眼中知是一家春	春
夕阳细雨斜阳里	夕阳
不是梅花有几人	人
老去归来不可寻	寻
梅花相结欲相寻	结
虽然镜里三千里	对镜
不是周郎一寸心	郎
仁德由来自有仁	仁
昔曾无事不沾尘	曾
一沟流水山前水	水
未省如今是故人	省
西上上湖船	船
江湖高画船	高
不知湖上道	道
湖上荻生莲	生
日日无归日	日
看花不见花	花
不知燕子子	子
重回几度对京华	重回
日日无归日	日
三声玉笛声	玉
梅花不胜胜	胜
不是水中情	水边
杨柳桥边绿树阴	阴
桃花野草柳阴阴	草木
主人记得东君子	钵
莫向尊前送客心	前
老子从来自有诗	诗
百年心事是平期	平
至今不说皆宾辈	阮
日日横横一抹时	横
不见梅花二十春	春
柳枝已拂杏花新	拂
须知造物应难见	难
不是梅花小主人	小
一阵东风带雨来	雨来
水边花树与云开	云
谁知不是人间地	间
自有游人不得来	自在
薰风初露露	泣露
凉露满帘风	风
露滴红煨烬	红
桃花数点红	红
不向山中宿	宿
梅花不是春	春
雪中闻鸟语	闻
声里是何人	声
往来高下时	长啸
我欲乞山色	乞
终日终日来	终日
谁能与渠我	渠
江上万重云	云
江南春意深	深
不知生处处	生
不是住伤心	住
春去春来早	早
桃花绿水东	东
西风吹落叶	西风
细雨雨声中	细雨
祥云拥彩云	拥
天气入乾坤	乾坤
日日通霄路	路
明朝入帝秦	秦
不见梅花二十春	春
春来物物物宜春	物
东风细雨冲寒去	寒
不是东风是主人	东风
欲去归来晚	晚
长江万里秋	秋
归来好风雨	风雨
何处懒回头	懒
杨柳萧条绿	绿
桃花草已空	空
朝来北窗下	窗
造物在春中	春
昨夜东风趁晚风	晚风
西风吹雨打孤篷	孤
游人记得江南道	道
只在墙阴暮雨中	阴
池上雪如雪	雪
花开琼玉瑰	琼
谁知姮娥洁	娥
不散故人来	散
安得牧牛牛	牛
主人少人游	人
行人苦苦苦	苦
何事苦回头	苦
零落青山古	古
孤山古寺前	前
白云无尽日	日
白鸟解苍然	解
不见庭前树	树
梅花在木边	木
夜来人不见	人
不是梦三年	梦
绿叶梢头月色鲜	鲜
归来日日到山边	山中
东风细雨催人去	人
一树桃花锁暮烟	锁
一笑不堪笑	笑
无心亦尔尔	尔
往来无所思	思
只在古今古	古
白石桥边一径通	通
孤村鸡犬过村中	孤村
晚来溪上千竿竹	竹
不见梅花到客中	客
明月湖边月	月
桥边柳色新	新
春风何处处	春风
知是故家人	家
南皇德德臣	臣
造物自闲闲	闲
谁知有嘉事	嘉
元不在人间	元
湖光照明月	明月
虞伯不可人	孟
庄子自相说	传舍
不见一枝枝	枝
桃花枝上一丛丛	丛
始见梅花入梦中	始
记得白头春色色	色
不将花发待春风	花
昔乐山中乐	乐
自乐山中乐	乐
风雨对烟雨	烟雨
寻诗不回首	诗
江南湖上客	客
不见芦花乱	乱
一声将雁来	雁
白鸟不飞去	飞
江上双双双	双
桃花不相笑	笑
留得雪中诗	诗
谁知有张去	张
桃花开牡丹	牡丹
折得一枝春	春
谁知六宫妹	宫
不作锦罗茵	锦
梦里寻花不见花	花
满城风雨又春斜	春
主人不是太平事	太平
不是更非桃杏花	非
秋风昨夜夜	昨夜
窗下读书书	书
欲向浯溪上	溪
故人犹读书	犹
此性从来本自求	求
不知何处实何求	药
不知形在知何处	形
忧患从来不点头	忧患
从来不辨时	辨
我不得官归	官
何事争何事	争
相逢不是归	相逢
只有一椽笔	笔
先生有麽生	生
主人都不识	识
今日与云行	云
何处不为君	君
问君不与君	君
主人从此分	分
何处堪青云	堪
西风吹雨下梧桐	桐
卧听猿声到月中	月
记得落花成一梦	成
不妨聊懒对西风	懒
何处不为君	君
山色今何爱	爱
昨日去年年	年年
行人尚尚尚	尚
世事从来万事非	非
故将车马濯尘衣	尘
如今更向山河去	山河
不是此身身未归	身
山色重重重	重
桃花花未开	花
池边零落落	村落
添薄又将来	添
桃花枝上一丛丛	丛
不见花开晓镜中	晓
待得故园茅拣在	茅
可能随浪嫁春风	浪
江上万重山	山
楼台爽气高	高
人心无此境	境
不画洛阳图	画
欲去归来晚	晚
扁舟犹未归	犹
扁舟向东去	东
不见落花飞	飞
胸中无一字	字
天下不如泪	泪
不是忍行人	忍
泪痕含露湿	泪痕
少年人事在人间	人间
不见桃花各自羞	羞
莫向广文天上去	文
令人留得子兰船	子
渺渺长江水拍天	天
扁舟长向枕中眠	眠
夜来记得湖边月	月
却把渔舟试钓船	试
祥云拥彩云	拥
日日终日闲	闲
不见陌上花	花
秋风弄潺湲	弄
流水满长沙	长沙
落花空落花	空
春来无处理	理
处处鸟栖鸦	鸟
春色浓如锦	锦
伤心一片心	心
一灯花影里	一灯
不是泪痕深	深
江北风高意气高	高
蜀江春涨望逍遥	春
秋光只在春光里	花光
折柳移梅过画桥	梅
梦里寻花不见花	花
一枝空对一枝斜	空
主人自是非吾事	非
知是庞公卖酒家	公
白云深处昔曾曾	曾
万里青山只隔层	隔
却忆武陵山下路	路
桃花处处是丹青	桃花
杨柳插桃花	插
桃花白白麻	麻
双双双蛱蝶	双
儿女竞莲花	竞
江北风高意气高	高
沧波波浪起波涛	惊涛
扁舟欲泛舟仙去	仙
只有扁舟语钓樵	语
春来气未平	平
叶叶青青青	青
造物不有恩	恩
故人不堪听	不堪
五月秋风冷	冷
青山处士家	家
老来元不尽	元
人是看梅花	人
老去归来去未休	休
故人何事不相留	留
个中只有无知意	有意
记得扁舟一扁舟	行舟
流水自清清	清
微凉日初午	午
造物不相亲	亲
游人不须识	须
扁舟江上舟	舟
江上一烟烟	烟
记得春风里	春风
愁人上钓船	人
造物是元元	元
飞来天上云	云
何如龙尾尾	尾
秋气满秋旻	秋
往事如相问	问
从来亦有官	官
关关无一事	关
莫作楚云安	云
桃花三百花	百花
一片一片片	一片
不与主人留	留
日日从教去	教
江上浮云度	度
扁舟艇子船	子
重来好山色	山色
何处在人间	人间
渺渺长江水拍天	天
吴江流水物依然	物
扁舟到处曾何处	曾
又逐潮生上钓船	生
