三径入青山	三径
新来水一湾	新
可怜江上树	树
又见春风还	春风
江南陌上人	人
归去未还家	家
不向山中使	使
归来不自劳	劳
燕子归来一炷香	香
归来不得趣来忙	趣
老来不得人间事	人间
惟有东风也自凉	凉
腊尽梅花雪未消	消
把杯沽酒试新浇	新
马蹄踏断桥边路	路
却踏青鞋过石桥	青
自是维摩手	手
谁知嗜季伦	剂
谁能能使使	使
借问复何人	复
江北江南九月天	天
分明吹笛起风烟	分明
归来江上全无事	全
教我扁舟上钓船	教
绿酒一樽酒	酒
东风朱邸寒	寒
欲从舟上去	舟
欹枕梦长安	梦
遗恨不堪恨	恨
多情直更长	直
唯有桃花雨	桃花
道人已断肠	道人
万事不为官	官
归来病治安	病
朝来忽相见	忽
莫作对花看	花
一夜风雷吼怒雷	雷
凛然形势已枯摧	枯
形骸满目江山远	远
记得春风细雨来	春风
昔人谁把酒	把酒
佳处见青山	青山
不是谁家女	女
何人曾解颜	曾
处处坚牢落	落
萧然想像台	台
时时人语笑	笑
不得自生来	生前
万里黄河贯问津	贯
君王须识赤精神	须
至今四海平如海	海
不作中书万里人	书
海上青山挂白云	白云
小桥流水两三分	流水
行人莫作船头坐	坐
雨洗秋江一片云	秋
白玉阶前一树阴	阴
君王宫女伴园林	伴
斜风细雨随人去	人
流水落花无处寻	寻
春来不忆君	君
故作卧山云	卧
不与书相寄	书
看花却忆君	君
桃李无花未有花	花
濛濛细雨夕阳斜	斜
不知野绠知何处	野
明日归来不到家	家
江南风雨送春归	江南
归去东归公未归	公
鸥鸟争争栖泊处	争
忽随柳絮忽双飞	忽
昔日登山忆故山	山
老来春事不曾闲	闲
如今不见游人面	面
静对清风自往还	静
金缕金黄金缕金	金
顶踵无穷更不禁	无穷
居人不见陌上人	人
先生正是先生处	先生
柴门终日掩柴关	关
只在清泉水石间	间
只有落花垂著处	垂
不知随处在云山	云
万事从来不是仙	仙
老来何事不因缘	缘
如今不入黄尘处	黄尘
只在蓬莱二百年	百年
一室萧然一秃翁	翁
西风一叶吹秋风	吹
年来物色浑如锦	锦
只在千秋秋雨中	秋
万里车轮转	转
山光海涌金	金
可怜千里月	月
应是醉中心	醉
风雨梅花一夜开	一夜
长松偃蹇探春回	夏
不随明月随人去	人
折得松松带雨来	松
多病常多病	病
那知别有天	天
故人今有道	道
今日思悠然	思
行人到处不当门	门
争得籯金是主恩	金
自是主人今未解	解
归来消得酒消魂	酒
月明池上雨	雨
初见凤池春	春
一夜桃花雨	空
还惊陌上人	人
一雨都无十日晴	晴
绿阴欹枕听檐声	窗
小窗人静人心静	静
惟有春风自有情	春风
风雨送行舟	舟
今日不举头	今日
柳花如绿柳	绿鬓
个个学离愁	学
不是安禅客	客
西风送雨来	西风
不知千万寿	万
不见落花开	散
一派黄河出大河	河
闭门相倚为谁多	倚
谁知不是江南国	国
不是行人也胜何	胜
路接南州路	路
朝衣上玉颜	玉
梅花应不拟	拟
何处问南山	问
为国化为国	国
重来弄返魂	弄
春来人不见	人
不是丈夫论	丈夫
多病常多病	病
无人更无人	无人
归来卧病根	根
卧病起前神	前
路接南州路	路
临风动别情	动
如今若为善	善
颠倒向南行	倒
浮云一万里	万里
遥见浙东吴	吴
此去渺吴楚	楚
归来亭亦无	亭
已怯东风柳眼青	青
梦中无处不离声	声
蝉声过尽天如雨	天
忽听西窗听雨声	忽
自有一砚水	水
昔人曾不曾	曾
问来缘底事	问
何处有清风	清风
临水骊山供不供	供
仙人引得上层层	仙人
游人莫向山中去	山中
我欲登山梦不登	梦
出岫拥寒云	云
山花照眼明	明
不知天上阁	阁
谁肯共倾城	肯
归来一万里	万里
不见两交亲	亲
不得归来伴	伴
情怀是故人	怀
物色净无瑕	净
吾生本无瑕	生
谁能拥鼻观	观
横吹看梅花	吹
一声寥落隔檐声	声
飞到须弥顶上行	行
更欲凭阑对秋雨	秋
岳阳楼上月分明	月
柴门终日掩柴扉	掩
刺刺猩猩血湿衣	血
今日恐轻江上去	轻
青山长送古人归	古人
万事不堪堪	堪
幽人意更幽	幽
我师无一事	师
行到到山头	行
天上老坡仙	仙
扬州渭水边	扬州
如今不容我	容
春草绿芊芊	绿
不是安禅客	客
闲来看月过	月过
归来多少小	小
阴处不作麽	阴
先生血策勋	战
落花开一架	架
独有伯夷时	夷
令人心白发	心
绿树阴阴薄	薄
千花气绿阴	气
想君人静处	君
回首尚伤心	尚
溪山佳处是吾乡	乡
花气熏人草木香	人
今日归来还有信	信
与公到处是重阳	公
稚子重来一布衣	布衣
老子重来一布衣	布衣
可笑老来羞妩媚	羞
落花满路劝人归	路
溪山处处有浯溪	溪
石壁乌藤万古碑	藤
今日登山人不见	人
重来重见重来时	重
突出林间屋	屋
蝉声入小窗	小窗
凤凰池上客	客
窗外读书窗	窗外
一阵东风作好风	风
江头春色已成空	空
分明一阵间梅雨	间
一片愁心似梦中	心
江南陌上人	人
雨逐天风驶	风
满地扫桃花	扫
桃花主人处	主人
江北江南九月天	天
扁舟楚客泊江船	客
可怜离别离情苦	苦
明日归来相送然	相送
记得春来看牡丹	牡丹
却将脂粉逞娇妍	娇
从教细雨催人去	人
争得还家似少年	家
不知何处不闻莺	莺
不是愁人自有情	人
昨夜东风多暮雨	东风
却怜遥听杜鹃声	怜
黄金殿里百花开	辟
一曲霓旌旆影来	影
一种百花千万树	树
落花飞上古阳台	古
万事似当年	当年
那知别有天	天
辽东今已老	东
应是梦中仙	仙
不得眼中书	书
不及溪边草	草
归来秋色空	空
啼鸟不相恐	恐
江南陌上人	人
香火自焚香	焚香
不知三百里	百
遥指顾咸阳	顾
一日归来一日闲	闲
玉炉香冷不生寒	寒
花开花落无花发	花
随分梅花看牡丹	分
篱落梅花柳色新	新
把杯沽酒买东邻	买
回头却被梅花笑	笑
不是渔人是钓人	渔人
太液池边柳色新	新
满宫寒暖不宜春	寒
凤凰池上黄金碧	碧
流出宫花万里春	春
落尽江南万里云	云
江山处处见昭君	江山
知君秋色知何处	君
一片落花红茜裙	红
初见枝头一叶红	红
秋光都在月明中	月明
夜来音去不归去	音
唯有落花多好风	风
千古长安石	石
婆娑一老芝	婆娑
登山还自有	自有
不是是闲时	闲
天地从来天地宽	宽
主人心事已衰残	残
莫嫌心事缘何事	嫌
只为南山隔北山	隔
一树梅花四十春	春
雨翻荷叶已精神	翻
老来不怕天风起	风
不怕天风懊恼人	风
不是当时节	节
清风是主人	清风
故人今有道	道
何处是高神	高
千年翰墨画难成	成
付与东风作好风	风
今日交亲无一事	亲
至今犹在在山中	犹
北山归去几经秋	秋
只有南泉水自流	水
山鸟不归人不去	人
一花随水到溪头	花
江南陌上人	人
拄杖一杖屦	杖
不是北边风	风
只在老松里	松
小桥流水自回环	回环
轻出菰蒲第一湾	轻
记得湖中春色胜	胜
晚来急雨对南山	雨
不是当时节	节
而今复主人	复
何人可怜耄	怜
一笑自精神	一笑
昔日游山不胜游	游
如今不见故山羞	山
夜来风雨催归去	呼
想见青山犹白头	犹
天文郑广文	文
登山如杜宇	宇
岳阳台上云	云
散作天上雨	雨
岩上一株松	松
山头日长日	日
归来一日闲	闲
那得清思处	清思
南国归来事未全	全
梅花应不惜春妍	春
也知行向山前路	行
只恐迟迟不著鞭	迟
万事似当年	当年
伤心忽忽然	忽
如今若为报	报
有客亦凄然	客
麻头白项翅如金	金
明日重来视出林	视
野野老来无到处	野
老来不是两贤心	贤
长短短长短	短
冰鉴如许长	鉴
明朝市朝市	市
何处在林塘	山林
满眼青灯照眼明	明
谁知疾疾亦多情	疾
閒居父老知何事	居
独有三贤向此行	贤
鼎鼐调羹手	手
先皇太乙先	先
欢娱方翥日	日
黄叶独凄然	黄叶
令人忆昔时	忆
今见不当门	门
如今君不见	君
西是上皇恩	西
细雨霏霏湿翠烟	烟
淡烟微雨欲粘天	天
游人不睡还堪笑	笑
细雨晴风更悄然	风
自有一诚斋	斋
多病亦多病	病
谁知有斯民	民
不能唤作鳖	鳖
春色自陶朱	朱
东风作好风	风
斜阳花影里	斜阳
应不到郎中	郎
不知天上帝	帝
不是雨随风	雨
万事非何事	非
吹香一梦中	香
一望吴城九陌头	头
北风吹雨下帘钩	钩
如今陌上孤舟去	孤舟
朱在杨花最上头	朱
两鬓峨眉不画眉	眉
至今风雨是愁时	愁
夜来风雨多愁恨	愁
却恨离愁愁不知	愁
不得安心法	法
不相色相同	色相
篝灯照眼明	明
都在万尘中	万
寒食多寒食	寒食
孤山尚未兴	兴
谁知见桃李	桃李
知是故人风	风
三十年来尚有诗	诗
更添宫漏漏迟迟	宫
今年春事无人识	识
正是长吟三月时	吟
西山明月夜	夜
月照洞庭波	波
惟有池边草	草
师师奈若何	师
安得胸中使	使
胸中有些子	子
胸中有此日	日
作雨不作雨	雨
十年不到五峰前	前
密密绵绵一坦然	绵绵
山色既残无尽处	残
却随风雨晓来天	天
细雨春蚕麦	麦
宫中歌舞人	人
三春春上雨	春
终日醉青春	醉
昔日登山忆故山	山
依然今日照孱颜	颜
如今不见青山色	色
留得红云带雨还	带雨
一室萧然一秃翁	翁
夜来风雨唤秋风	唤
石头万事成何事	石头
回首依然一梦中	依然
细雨作堆盘	堆盘
万象森罗列	列
不知双眼底	底
少妇饷耕去	耕
溪山佳处且迟留	留
何处重来双屐齿	齿
归去归来不记年	年
松间绿酒一樽酒	酒
万里猿声杳不闻	闻
鸡声一阵晚风飘	飘
凭谁为乞吴山色	乞
不得胡尘到六朝	尘
南国重来有此心	心
行人不见故山深	山
十年不到扬州路	路
此去何关一寸心	关
本不与诸贤	诸
我亦不为眼	眼
所以化为底	底
更可一时见	一时
百年不似北山居	居
此乐其如此乐无	乐
独向西窗北窗下	窗
清风何处且踟蹰	清风
酷暑天寒暑气侵	侵
萧萧疏雨占春阴	春
雨声唤起行人耳	耳
不惜骚人一寸心	惜
明月照清寒	清寒
人心如此孰	孰
一夜风雨来	风雨
西窗夜犹热	犹
溪山处处一花开	梅花
却恐春风细雨来	恐
细雨隔帘风细雨	风
水边人见杏花开	人
夜深云气烈	烈
谏起腐儒冠	冠
何事不知世	世
当门处处安	门
打破虚空事已空	空
夜深一夜听悲风	夜深
六宫闭户知何事	宫
都在诗人一梦中	诗人
当年张丽华	华
玉腕玉无瑕	玉
何人知我怀	怀
健妇吃黄花	健妇
不入壶中别有天	天
行人到处恐依然	恐
当时好景知何处	当时
有客重来是几年	客
造物不相容	容
金针刷毛羽	羽
如今昔不来	昔
今不下庭户	庭
临水登山尚尚余	尚
梦中初见竹轩舆	竹
故人争得相争处	争
安得闲身不读书	身
龙舟处处见龙舟	龙舟
鸥鸟相呼最上头	呼
想得此行行上路	行
却随拄鼻到山头	鼻
不是晋诸贤	诸
而今莫谩然	谩
欲从何处行	行
老子出扶田	扶桑
风月在尊前	前
数声更萧然	数声
灵岩在何处	岩
与我话凄然	话
老来何事太匆匆	太
细雨馀香一梦中	香
料得此身缘底事	身
华胥一枕梦西风	梦
野花初见野花开	野花
纵有才名去不来	名
正是游人行到处	行
又分吹雨上楼台	分
细草飞花不作泥	泥
春风细细细初齐	细
游人不解留人意	意
明日但令啼鸟啼	令
麻衣不着六铢衣	衣
那得皇华到者稀	华
若使本来无内使	使
他年留得去年归	年
不见长安石	石
莓苔拂紫苔	紫
落花无处问	问
犹自入山来	山
一夜西风雨露寒	寒
白沙滩上白沙滩	滩
渔人起起船头卧	卧
却是荷花有意看	有意
万事从来不是仙	仙
一炉茶灶炷香烟	香
炉中更有双蝴蝶	蝴蝶
却入僧房宿昼眠	宿
数间茅屋对青山	青山
杨柳清风自往还	杨柳
记得重来同宴坐	坐
又随风雨送君还	君
燕子归来未肯归	肯
又将双泪向人稀	人
不知多在西林处	西林
唯有落花春自飞	春
玉殿初从玉殿开	玉殿
曼卿相引上瑶台	引
谁知玛瑙阶前水	水
今夜难随细雨来	难
桥下水如水	水
落花江上愁	愁
扁舟向前去	前
摇落水中秋	秋
寥寥寥落九天风	风
杜宇遥怜明月中	怜
落尽落花春已尽	春
又将春雨费春风	费
风雨乍飞来	乍
霜毛拨不开	霜毛
谁知故耆旧	旧
不得梦归来	梦
西山明月夜	夜
影转冰轮转	转
塔影动风光	影
飞过石桥水	水
绿草连云护石城	护
一霜开尽绿阴晴	霜
梨花落日松风起	松风
只有山头山水声	山水
寂寂泉声静	静
沉沉月影残	残
古来怀宋玉	玉
肠断楚云寒	云
一派泉声汹汹流	流
不知草木在山头	草木
如何不得长生药	药
此地根深也不收	深
风霜憔悴鬓如霜	霜
春色已随春日长	春
一夜夜寒寒夜雨	寒
又将春梦入诗肠	诗
江南陌上凤凰儿	儿
明日西风惊起时	惊
应是使君离别处	使君
宫中春色识谁知	识
百花锦如锦	锦
春色不如君	君
如此化为客	客
恼人愁杀君	愁
三十四时都不记	记
不知何处不逢人	人
落花山鸟应相笑	笑
不是桃花别是春	春
一气中元气	气
壶中别有天	天
胸中有欢喜	喜
兄弟自萧然	兄弟
微风细雨绿槐阴	阴
寂寂风光暑气沉	醒
细雨入山春意静	山
还将白鹤照人心	白鹤
把酒不堪醉	醉
那堪折赠君	君
谁知北窗下	窗
怜我与诸君	怜
月色浑如水	水
归来不是间	间
不将花鸟弄	弄
疏悴不相关	疏
一阵东风作好风	风
水边春草绿茸茸	绿苔
寂寞游人皆寂寞	寂寞
一年春事总成空	空
细雨霏霏湿翠烟	烟
人间处处是春天	人间
谁知不是归僧处	僧
犹向青山记少年	犹
阕兮金叵罗	罗
兮兮珊瑚树	树
凤兮落不来	落
呆兮归来晚	晚
夜泊扁舟古岸傍	傍
秋光初破水云乡	破
归来十里平湖里	十里
何事应须是醉乡	须
燕子归来春意深	深
倚楼邀月独伤心	月
隔帘风静莺声静	静
谁弄珠帘弄舜琴	弄
细雨浮云忽忽来	忽
扁舟行到画船回	行
一株杨柳堤边柳	柳
杨柳裙腰拨不开	腰
一夜西风雨露寒	寒
乱飞阵阵满阑干	败叶飞
可怜一夜吹空雨	空
借与诗人作病看	病
万事寻常事	寻常
行人不作泥	泥
青山无尽日	日
何处是将军	将军
五载西湖五载归	五载
老来心事孰如希	孰
片帆冲雨冲云去	云
老尽衰颜更不归	颜
十日又春风	春风
都将万物同	万物
春来不催去	催
都在月明中	明
十年不到五峰前	前
细雨临风紫自然	紫
料得人间缘底事	人间
壶中都是玉壶天	天
声中惟有一般声	声
一别离离别是春	春
今日归来无尽日	日
不知何处不愁人	人
落叶萧萧一叶秋	秋
夜来风雨见春愁	春
老来不得知何事	何事
一雁南飞不点头	飞
昨日西园一种梅	梅
小桃初见杏花开	小
别来天上谁相赠	赠
又是还生逐雨来	生
暑气薰风暑气凉	凉
眼明疏雨洗秋光	明
落花木落寒山静	山
唤起还惊不断肠	惊
天上长安道	道
东南四十州	州
谁能将剑气	气
不是好风流	风
澄波万顷濯沧波	波
杨柳烟低柳绿多	绿
流水落花争著处	争
杨花处处识笙歌	识
孤峰顶上云	云
松下一僧起	僧
飞来岩上空	空
孤松下华岳	华
狮子不知谁氏子	子
梅花作雨不作雨	雨
不是行人不作愁	愁
却向街头看未足	足
不见山头月	月
轮囷一转中	轮囷
夜来颠倒影	影
天上万人风	人
人间万事非	非
不知非是非	非
送我不送归	送
竹林乔不归	乔
忽闻天上雨	雨
不见车马革	革
安知不是空	空
今日棣华起	华
朔风吹雨被风吹	风吹
努力驱人去不移	人
记得江南江上路	路
故人闻道立多时	道
天上蓬莱第一尊	尊
玉皇天下语龙门	语
南山只在云何处	云
独对南山行不言	行
日暖春风暖	暖
园花一树芳	芳
不知离别恨	恨
移影落花香	影
陌上三番女	女
莲花万里香	香
不是真人处	真人
凭虚对夕阳	虚
昨日清风细细推	推
不知天上少牙牌	少
海棠花发浑无事	花
偷得閒游处处来	游
一树无花尚有花	花
归来终日觉横斜	觉
春来岂是无情物	物
江水重来自一家	江水
秋风摇落九天风	风
荷叶披毛拂镜中	毛
好是吴王王乐处	王
岂惟憔悴对秋风	惟
把酒不堪醉	醉
看花不自持	不自
起来三伏枕	枕
正是月来时	月
天上长安道	道
今朝泪湿衣	湿
胸中三百果	果
今日未全归	全
物色虽无数	数
谁知帝自亨	帝
欲知家造物	家
不是冠冠名	冠
把酒不堪醉	醉
行人不解愁	解渴
登山自自有	自有
还自向渠头	渠
春来不忆君	君
如今迹已陈	陈
落花泥不湿	泥
何处惹埃尘	尘
了无一事不为官	官
不与行人路往还	路
若得禅关无一事	关
九渊何处是骊山	渊
归来方隐隐	隐
茶灶炷熏炉	炉
老子真成事	成
真龙作画图	龙
孤棹归来岁月孤	孤
江南南北故应无	南北
如今两鬓浑如雪	雪
折得梅花作画图	梅花
江北江南一片帆	帆
不知名与海天宽	名
老来何事浑无事	浑
莫作临流洗眼看	临流
独向山中宿	宿
犹堪忆旧时	犹
雪消消不尽	消
心事不堪悲	虚
打破虚空事已空	空
方知法界有余踪	有余
何劳不用劳无力	劳
那得须弥顶上峰	顶上
风光凝不流	流
寒食广寒食	食
行人不直下	直下
是不是佛子	佛祖
千峰崷崒白雪中	雪中
滔天地险与天通	天
登山临水倦游处	游
却向南山认北风	认
旧事无人问	问
林中有好风	风
至今无壮岁	岁
更觉几年中	觉
百年三十日	日
一见一齐腰	腰
今日如君日	君
相寻过石桥	寻
何事归来更不惊	惊
夜来风雨泪痕新	新
故人知是谁家女	女
赢得钗头白似银	银
闭门终日欲驱车	车
今日经旬不属车	车
日日归来三日日	日日
又将白浪看黄花	白浪
一树梅花四十春	春
共游杯酒倍精神	游
落花不管年年事	年年
惟有荣枯似故人	枯
乞与幽人一炷香	香
此山长与故山长	山
归来归去休休去	休
看到中原亦可伤	原
方知不漏泄天机	悟
身世推求总是非	求
若是不圆圆缺处	圆
百花香里更沾衣	香
一时同调不同调	调
日日留留作别调	留
流水落花无限意	意
却将流泪费长桥	费
夜来风雨更凄凉	凄凉
白露沾衣出锦囊	囊
唯有游人不相忆	忆
濛濛烟雨满斜阳	烟雨
一种桃花陌上游	游
胸中惟有许风流	许
从来乐事如今日	今日
不是游人不上楼	楼
欲去去复复	复
归来万里风	风
归来衫袖薄	薄
知是楚王公	公
一雨东风柳眼青	青
归来十里不关情	十里
山中更有谁云雨	云
不是看花巧不成	巧
不向仙家住	住
归来燕颔须	须
老来无限思	思
独自镇长安	镇
长安陌上簿书生	书生
心事常欺不世情	欺
今日为君无一事	君
落花风里听泉声	风
初入武陵溪	溪
归去不须辞	不须
处处坚牢落	落
还家忆旧时	家
昔年湖上客	客
春事一时休	休
今日来相访	访
谁禁最上头	禁
老来犹记记当时	犹
满面风光翠画眉	翠
自是元来无一事	元
不知天气有谁知	天气
夜来风雨不胜秋	秋
又见梅花喜点头	喜
吹尽落花人不见	人
北风吹雨到山头	始
万壑千山隔	隔
相逢不相逢	相逢
令人不相忆	忆
君作万家钟	君
一夜清风入梵宫	宫
清光万里万春风	万
西风吹散梅花散	散
尽在黄河汉汉中	汉
不随车马走	走
何处不伤春	春
且向樽前醉	醉
何缘是主人	缘
物色知多少	少
行人得意多	得意
虽然一缸面	面
那得奈郎何	郎
不见山头月	月
重来不涌金	金
谪仙得仙去	仙
不是杜陵心	陵
又向桃花陌上行	行
从来豪气恣纵横	纵横
不知走马桥边路	路
行路应须马上行	须
昨日驱车趁晓来	晓来
归时但见见花开	但见
从来风月如今夜	昨夜
秉烛将残把一杯	残
故园春色自芳菲	芳菲
又见花间白鸟飞	飞
落尽落花人不见	人
又翻风雨送人归	翻
淅淅溪流涨浅沙	沙
此身处处是谁家	身
也知行路难佳处	难
却向沙边见菜花	鹿
昔日咏淋漓	咏
吟风细细奇	细
至今无此曲	曲
今是向东时	东
万事重来有此心	心
老人心腹负如今	负
老来更有依前事	前
老子归来子更深	子
细雨霏霏湿翠烟	烟
诗人人意独凄然	诗人
梨花折尽无花发	花
御水看花又几年	水
江山常在水云乡	乡
归去重来赖断肠	赖
自是无心惟有酒	酒
杜鹃声里别愁肠	声
急泛扁舟趁晓晴	晓
谁将太白发分明	发
洛阳陌上新新雨	新
不是秋霜看不成	秋霜
微风细雨绿槐阴	阴
只有梅花慰客心	客
如今不作西流去	西流
雨过西楼月更深	月
海上玉龙飞	龙飞
墙东向北归	东
侍臣宣诏诏	臣
先赐御烟衣	烟
昔日登山忆故山	山
往来处处阻跻攀	寻
今年不是他年事	年
只在人间在世间	人间
一片孤云去不移	移
每逢佳处少迟迟	少
至今荒冢无穷处	荒
正是梅花斗草时	草
归去几重重	重
归来寒几重	寒
主人今不见	主人
终日不相逢	终日
千年垂老鬓斓斑	鬓
三百年来身等闲	身
今日落花人不见	人
不知春事在人间	世间
块石嵌拉启	启
东方识圣人	不识
圣人都不杀	杀
岂是太尧仁	太
山色浑如画	画
随风忽忽来	忽
封题作诗句	题
黄鹤为谁开	黄鹤
三月宫花一样妆	妆
百花初见石榴芳	芳
从来知是东风处	东风
到处谁教柏子香	教
春色浑如玉	玉
萧然一病身	身
会须缘底事	须
知是故林神	林
昔日谢苏公	公
周郎事不同	郎
好风三更雨	风
夜雨送秋风	送
烟雨连天云水接	接
游人归去未还家	家
闭门尽日无多日	日
只有春花看落花	春
万事不应难	难
风高浪漫漫	浪
不知三四海	四海
莫作举头看	宣
帝子归来今始知	始
满庭花影影迟迟	影
十年不到经行处	行
始是重来送别时	始
浔阳陌上立西风	西风
梦里惟闻一梦中	闻
最是江山佳处处	最
月明都在月明中	明
东都是故基	基
惟有一株梅	梅
东望一千里	东
还随夏木来	木
万事从来作麽生	生
金篦打彻底惺惺	底
坚牢瞎得当头瞎	牢
却向街头更不鸣	鸣
野苑东风渐渐稀	野
苑西斜日照斜晖	西
双双蛱蝶令归去	令
趁得杨花也误归	误
老来一事不为官	官
何事还宜拥鼻端	宜
不是行人莫相送	送
夜来风雨落春寒	落
山北江南万里云	云
老来不可不王君	不可
武陵寺里曾归去	曾
却向长安数十分	安
昔人来不取	取
不见故人居	居
惟有衣冠汉	汉
惟愁不读书	愁
北风吹雨出长干	干
谁与诸君细细看	清净
只在红红花影里	红红
不知何处识春寒	识
凤凰池上雨	雨
飞上水边梅	梅
独向池塘里	池塘
孤吟过雁来	吟
出岫拥寒云	云
钟声何处闻	闻
故人缘底事	问
此月是昭君	月
君子是先生	先生
归来犹未行	犹
何人能乞我	乞
何事亦难成	成
行人到处不当门	门
心事真成亦自存	成
岂是人间有归兴	兴
自惭刘阮亦无言	惭
一事谁为尔	尔
归来喜眷颜	喜
梅花无一事	梅花
知是树南山	树
五百年来意气佳	佳
中原和气到天涯	原
无端的的知人意	意
万事休休尚可夸	休
一间茅屋对青山	青山
携酒归来春自闲	春
把酒看花应不胜	胜
东风吹上玉朱颜	玉
空山明月夜	夜
梦入巫山梦	梦
青灯照眼明	明
时听枕边声	声
春来不忆君	君
欲泛剡溪曲	溪
中有金黄金	金
落花更无数	数
百年三百百	百
终不受胡尘	尘
父老容何事	容
重来愿主人	愿
百花如锦绣翚飞	飞
流向银河去不归	河
今日春风人静处	春风
看来还是泪痕时	泪痕
子美谁为美	美
梅花伴太迟	伴
移阴在何处	阴
身在碧中时	碧
少年和气入文章	文章
万事翻思日日长	思
老子老来须一事	须
读书窗下读书香	书
不唱袁州曲	曲
曾为楚客来	客
白云收不得	收
归去未休回	休
乞与幽人一炷香	香
枝枝叶叶染青黄	红
谁知不是无公子	公子
付与东皇上玉皇	东
老来何事不胜愁	愁
杜杜鹃啼最上头	啼
流水落花无限思	思
一琴樽酒别离愁	酒
激箭箭如箭	箭
谁能救屈平	平
当时无用处	当时
时有落泉声	落
去年十日已登登	登
此去重来一倍增	微
折得百花千尺锦	锦
不知何处且迟登	迟
粝食饥寒食	食
馋涎作剑烹	剑
料得南山老	南山
悬知特地生	生
翰墨本来如翰墨	翰墨
不如今日笔毛锥	今日
如今翰墨今知失	失
援笔方知是此时	始
老子坐中坐	坐
老子心如水	水
万事不纷纷	纷纷
回头还不睡	睡
岂是知人意	人意
须知不是行	行
莫嫌山路远	远
知是远归程	远
万事从来乐事优	优
令人多感感离愁	感
今年不作千年恨	恨
须向青山最上头	须
风雨过江南	江南
平溪满碧潭	溪
六朝天上去	六朝
画图在江南	画图
默默无言自不言	言
不知全体是庄严	严
谁知不是依前事	前
赢得江南又卷帘	江南
佛法从来不与俱	俱
通身是佛是间无	间
如今不到林泉处	林泉
自古勋名总是无	名
不入南州路	路
何处见秋风	秋风
知君在何处	君
明月月明中	明月
乐府归来一炷香	香
摩诃池上麦初黄	黄
老来不得逃名姓	姓
一种梅花已姓杨	杨
稚子悲欢喜	喜
归来百感秋	秋
归休无一事	归休
今日共寻游	寻
江山虽不用	不用
何事不相期	期
独有虽延寿	寿
如君在此时	君
秋风摇落九天风	风
菡萏红蕖绿水中	水流
料得桓伊无着处	伊
芦花深处不闻钟	闻
万事有无间	间
处处见君山	君
惟有一炷香	香
三月五更寒	寒
绿柳千株绿	绿
清波绿影中	清波
不知人意少	少
憔悴是春风	嫌
老来万事不相容	容
只有鵷雏习气浓	雏
自是屈平无一事	平
人人只道是元龙	道
行人到处不当门	门
一带孤烟过远村	烟
草木荣枯已枯老	枯
至今犹恨未消魂	犹
夜来风雨不胜秋	秋
多在长安独上楼	长安
今日思君无到处	君
夜寒寒月别离愁	寒
昭阳寺里千竿竹	竹
长忆昔年曾读书	曾
细雨落花人不见	人
故搴红袖拂香裾	香
落叶满琅玕	琅玕
泉声散广寒	散
青山无尽日	日
直向眼中看	直
开尽梨花菊已残	残
不知谁是客长安	客
别来只在秋光里	秋光
正是离愁人不难	人
春色浑如玉	玉
壶中日月迟	迟
天涯无别处	天涯
正是穿云时	穿云
腰缠缕缕缕萦缠	缠
楖栗笼中鱠缕牵	遮
赢得丫头长著脚	脚
又抛针线信青钱	信
摇落梅花蕊	蕊
梅花对雨开	雨
文章在何处	文章
归去却成来	成
万事常多感	感
春来尚好风	风
此中无人识	识
惟有一花红	花
细雨霏霏湿翠烟	烟
梨花如雨雨含烟	雨
北风吹笛休吹去	吹
不作西楼一夜眠	眠
乐府归来一炷香	香
莲花洞里拥禅房	洞
谁知漏泄春光处	春光
细嚼梨花一炷香	瘦
万事无人识	识
依然碧碧幢	碧
游人不具眼	眼
那得自何生	何如
一臂一半臂	臂
臂中弹一镞	沫
臂上更无人	无人
秋风开一夜	一夜
池上千株柳	柳
光中万里身	身
水边栽满地	栽
还是旧时人	春风
万事从来作麽生	生
又随风雨作寒声	寒
老来不作封书梦	书
又见梅花照眼明	明
昔日登山忆故山	山
十年今见古诗坛	古
如今不是恩波处	恩波
又见青山水一湾	水
打破虚空事已空	空
芳心心事与谁同	芳心
如今两鬓浑如雪	雪
添得杨花万里风	风
万事当时都勘破	破
碧纱窗下读书窗	窗
十年不到经行处	行
休向长江一曲江	休
埋尽南山战战场	藉
将军又见雁河阳	雁
当时曾到经行处	曾
风雨萧萧竹隔墙	竹
江南陌上人	人
走马去迟迟	迟
想见伤春处	春
看花著意归	意
万事从来太阿娇	娇
妻孥活计亦何劳	妻
谁知不是寸心事	寸心
却恐令人筋力豪	恐
两鬓浑如雪	雪
蝉声出暮云	暮云
梦中闻不语	闻
不是妒昭君	妒
碧天如水水如水	水
二月风光月初发	发
不见梅花不忆君	君
与我与君一杯酒	君
何事归来更不惊	惊
不知何处不堪行	行
一春日日知何处	春
卧听茅檐新雨声	新
日日西湖上	湖上
青山满白云	白云
桃花护生处	生
不见古来稀	稀
百草堂前一树春	春
举头又见一番新	新
从来大地火如火	火
便是西山与北人	北
已怯东风柳眼青	青
归来依约住山亭	山
青山万里三千里	万里
却向人间枕上听	间
乞与幽人一炷香	香
却疑佳处是斜阳	疑
山中都是一年事	一年
仙去不来春日长	仙
茅檐风雨泻檐声	声
花影高低日月明	低
看到平明无到处	平明
向西门外更多情	西
临水登山不可寻	寻
莫将造物放人心	放
欲知一片伤心处	一片
嗔到扬舲到夜深	嗔
初不是阿衡	衡
夜来风雨明	风雨
风流一溪曲	溪
不是客多情	客
湖上一孤舟	孤舟
离群最上头	群
芙容梳洗处	容
还似别离愁	青山
连朝风雨正纷纷	纷纷
梦里人家不到家	家
唯有落花深带雨	深
当年处处种梨花	当年
寂寂空山半夜钟	钟
人间处处有龙钟	人间
老来不是先先事	先
且向云山认取侬	取
春去春来不忆君	君
野花芳草亦无心	无心
多情未尽人间事	人间
细看残花度绿阴	雪
三十年来尚有诗	诗
老来何事不能追	追
如今旧事君知否	君
且作灯前一首诗	诗
公子归来天地平	平
相寻无路到山城	寻
游人不得暂归去	暂
惟有一秋无一声	秋
身是当年一病身	身
不知谁是不归人	人
老来读破除书事	书
不识重来不识真	不识
身是当年一病身	身
老来心事已陈陈	陈
朝衣粝饭缘何事	衣
尽日登山忆故人	日
日落征帆落	落
苔痕溅雪痕	雪
不嫌山驿使	使
吹雨入柴门	春风
一树桃花满树红	红
北风吹雨落花风	风
今朝欲去不归去	今朝
明日归来秋色空	空
枝头荷叶堕	堕
攀折寄横枝	寄
惟有钱塘水	水
黄花烂漫时	漫
晓色祥光淑气浓	浓
祥光滟滟水溶溶	水
睢阳淑气知何处	阳
烟雨蒙蒙瘴雨中	雨
小小姑苏小	小
飞来锦帐前	前
陶陶陶白酒	陶
好景咏诗篇	景
修竹修篁十万竿	竿
年年心事到长安	年年
如今只在晴烟里	烟
不作西风六月寒	寒
自是当空手	空手
无人倒骑来	骑
不知人不识	人
随水到天台	水
百年虽壮岁	岁
萧然傲冕旒	傲
如今见君节	君
不遇遇狐裘	遇
眉毛衰鬓鬓斓斑	鬓
老子无诗更不悭	诗
李白鸥盟须一事	须
莫将援笔写骊山	写
造物自功名	功名
人心宛宛转	忽
沧海变将来	变
吾心是何事	心
愚智由来自有神	神
不知不惑是何人	恣
旁人不识知人意	意
便是山头第一人	第一
行藏不覆藏	藏
覆步入梵宫	宫
溪山深处行	行
到处直当空	休
青山无处觅	觅
一路净无尘	尘
自是满怀处	怀
时时是故人	足
按部笙歌杳不闻	闻
梦中闻道梦中闻	道
不知多在西山处	西山
一带夕阳起暮云	夕阳
燕子西来处处求	求
夜来风雨满空愁	空
夜深不见池边树	树
只在桐花最上头	花
南州是赵州	州
已放北山头	放
一种千年色	色
杜鹃声里愁	声
细雨随风入虏庭	庭
百花亭畔旧新亭	旧
游人若问知何处	问
应不移文入画屏	文
江上旧楼台	旧
连云千万里	万里
游人未易来	易
便欲移船去	船
归去几重重	重
梅花乱雪中	雪
半山无尽处	半山
何处约春风	约
凤凰池上雨	雨
池上无春色	春色
东风作晚凉	晚
池上无方直	直
本来真法界	法界
不是万机人	人
个个圆如箭	箭
依前不是亲	前
画船初出大堤边	堤
柳絮随行复著鞭	复
我欲凭君更沽酒	君
一痕细雨涨寒烟	痕
江北江南九月天	天
扁舟难处泊渔船	难
若教不向江南去	教
又作江头月上弦	弦
帝子重来玉座中	玉座
一车风雨送春风	车
只应流出西河汉	汉
那得骄兵入梦中	虏
声中惟有一般声	声
心事从来自不安	不安
安得老黄千万里	黄
何劳劳不到长安	劳
已怯东风柳眼青	青
更将鞞鼓入诗情	鼓
可怜太史州青史	州
自是无人是旧情	无人
一去几重重	重重
归来不可呼	呼
至今收拾尽	收拾
何处不教愚	教
枕上钟声出翠微	微
落花流水篆香肥	香
扁舟欲去还收去	收
我欲齐梁去不归	梁
凤凰台上凤凰台	台
一缕新丝带雨来	新
莫谓三公无一事	三公
何人献得杏花开	贺
北山归去几经秋	秋
十在西山最上头	十
怪得归来无一语	语
却将明月为君愁	君
老子不知谁氏子	子
白头惟有四时花	花
也知今岁三千岁	岁
每到楼台自一家	楼台
故国归来自有期	期
千峰玉立立多时	玉立
青山自是无藏处	藏
何处有人人不知	人
一树千株碧	碧
梅花百尺间	间
移舟舣舟去	舟
不得到南山	不言
一种桃花陌上游	游
一帘春雨带春流	春
眼中只有桃花信	信
白鸟飞来江水头	江水
打破虚空事已空	空
回头醉倒影随风	影
老来物色今无数	数
且献参差四座中	献
平生万事太平生	平生
手把豳诗画不成	诗
莫把文章无一事	文章
不知何处是严陵	陵
江南陌上人	人
江南春色空	空
谁知有书处	书
何处是秋风	秋风
群鸦飞上苑墙东	东
帘卷珠帘别殿中	殿
黄鹤楼头春日暮	暮
一帘花月对秋风	花
夜来风雨不胜秋	秋
细雨疏疏疏不瘳	疏
细雨落花无限思	思
世间何事不胜愁	愁
老来心事太匆匆	太
万事依前一梦中	前
折得百花千尺锦	锦
白云何处是虚空	白云
出岫拥寒云	云
青山漫漫分	漫漫
南山对秋雨	秋
擎出一山云	娥
老子坐中坐	坐
恼人还独卧	卧
不在人间间	间
诗将一杯酒	诗
南北东南第一州	州
全身不是等闲游	全身
渠侬不是关渠事	渠
却是渠渠最上头	渠
佛法从来不自修	修
心通佛法在心头	心通
老来不是观书句	书
却向柴门闭白头	闭
却怯东风一样轻	轻
归来不作一般声	声
频来燕子知何事	频
三百年来不得名	名
昨日归来白草堂	堂
又随风雨送斜阳	送
归来归去无寻处	寻
白鸟飞来又过墙	城
老子当年事已成	成
归来何事竟难成	终
如今不得诸诸事	诸
老眼看来总不成	总
老来眼底事难成	成
折得千条百万茎	万条
折得鲛绡裁不得	裁
春风吹作杜鹃声	春风
岩上一株松	松
桥边道路通	通
谁知有筋力	力
不是不言功	功
江北江南九月天	天
碧天如水水如天	天
此山只在山深处	山
一片飞帆泊画船	飞
昔日登山忆故山	山
满湖春水涨新湾	新
昔人知我非何事	非
又作东风五月寒	寒
归去谁为主	主
归来尚有诗	诗
归来不得句	句
正是太清时	清
园里桃花不见春	春
向来随驾丧精神	驾
宫中记得西成事	西成
万事依前是主人	前
一树无花尚有花	花
不如蝴蝶逐儿斜	儿
看来不到经行处	行
梦断桥横一万家	横
日日归来三日日	日日
小楼终日醉初醒	醒
今年不是今年事	今年
只有残书一夜星	书
多病常多病	病
青灯半夜灯	青灯
梦中闻不语	闻
飞上雨千层	雨
不是安禅客	客
归来忽忽来	忽
不知非一事	非
不得故林开	林
三年习气满沧洲	沧洲
万顷平湖万斛舟	舟
不是胸中谁谨护	护
不知春色自风流	春色
昔人不具眼	眼
万事总萧然	总
造物浑无事	浑
归来晚自然	晚
独上危楼独倚栏	倚
落花都在醉人间	醉
游人不放当时事	放
休得归来一等闲	休
不着六铢衣	衣
籯金本无瑕	金
谁能化为土	土
夫子亦争夸	争
桃李无花未有花	花
夜来风雨又春斜	春
年来陌上春初觉	觉
影落窗前树影斜	落
江南陌上人	人
到处皆寂寞	寂寞
何处不遇来	遇
一夜听风雨	一夜
渡头初咫尺	咫尺
都在水中虚	虚
却向阶前处	阶前
还将此夜书	夜
旧事无人问	问
渔蓑自往还	蓑
落花千树树	树
人我对南山	人
园里桃花不见春	春
杏花枝上翠烟颦	烟
桃花到处多情懒	懒
偏得黄鹂作主人	偏
年年陌上访刘郎	郎
直至如今不见郎	郎
自是无穷通到处	通
却来天上信斜阳	信
江北江南春色深	深
游人已觉更伤心	觉
看来不是无花木	木
只道看花意更深	道
昔日丹青手	手
登山去路遥	遥
不知山路隔	隔
飞过水平桥	月
山北江南万里云	云
北山归路杳犹闻	犹
夜来细雨新新雨	新
更听雨声频送君	频
山北江南万里云	云
北风吹雨玉纷纷	玉
山头柳色浑如雪	雪
惟有梅花寄使君	寄
乐府归来暑气清	清
春风何处更多情	春风
秋光满目烟波阔	阔
不见青山一点青	青
江上秋风急	急
长江万里程	万里
千古功名在	功名
行人不道兵	道
不知何处不相携	携
坐石桥边绿草齐	坐
自是山中有欢喜	喜
却於愁里听猿啼	愁
开尽梨花菊已残	残
秋风吹雨怯秋寒	秋风
闭门尽日无多日	日
且向他山细细看	山
万事不曾曾	曾
谁知不是秦	秦
别来宁复复	复
不是旧时人	公
一夜东风结冻云	云
乱山佳处忆昭君	山
老来始觉知无事	始
今日登山又送君	今日
江上秋风动	动
寒虫更怯寒	馋涎
堪怜谢安石	石
为我性长安	性
何事重来有此心	心
因缘未了又还生	生
夜来归去香何处	香
满目山光湛月明	湛
年来宁复复	复
事底事堪悲	底
何事无人问	问
鸟鸣蝉噪时	鸟鸣
酷暑重来暑气清	清
笋舆走虺斗铮铮	斗
归来不入长安路	路
却向溪山处处行	行
太液池边树	树
池中抱寿觞	抱
君王王圣寿	王
百尺寿封疆	百尺
吴王宫殿锁烟霞	锁
月色秋光射暮鸦	射
宫女墙头春色紫	紫
君王宫女拜宫花	拜
不知谁是与刘郎	郎
匹马黄花满道场	马
四十衰年无一事	年
为君看作百花香	君
初入武陵溪	溪
陌上杨花冷	冷
陌上送行人	行人
今日相思去	思
湖光渺渺渺湘江	湘江
流到淮流更断肠	流
料得此心无一事	心
悠悠烟水两茫茫	悠悠
去年十载未归来	归来
每见梅花记未开	记
惟有故人知此意	意
看花应被使人猜	人
归去重来不是家	家
著鞭蝉鬓少年华	鞭
至今陌上人无事	人
却向门前看落花	门前
从来万事不争先	先
况是经秋多少年	秋
何事元来无一事	元
此心心物自悠然	心
平沙漠漠绝纤尘	漠漠
隔水平沙映问津	映
赖有故人揩画手	手
不知天地与宽臻	宽
鞍马停鞍马	鞍马
駸駸车马间	间
行人苦辛苦	辛苦
不见夜南山	夜
老来人物自交情	交情
万事茫茫过此生	茫茫
应是故人安得得	安得
相期何事未忘情	期
不作羲之时	之时
安知我亦难	难
危疑无一事	危疑
应不与人看	人
东风一样轻	轻
为我与君行	君
不作寻常念	念
他年一世荣	年
世事从来世世稀	世
举头始信美人归	信
不随明日入城去	城
赢得当门一布衣	门
春来不忆君	君
无计备山云	备
及到三清处	三清
知天似使君	天
稚子悲欢喜	喜
还从此地分	分
老来应有想	想
悔不见书君	书
枝头一叶叶	叶
山中无尽日	日
从此作麽生	生
蜻蜓自忙误	忙
日日上危亭	亭
残灯半夜灯	灯
归来无尽日	日
出口到巴陵	口
百啭黄鹂不数声	数声
故人家里更多情	家
故人到处疑无事	疑
卧听寒寒听雨声	寒
乞与幽人一炷香	香
山头日日日偏长	日
鸳鸯睡起微风起	睡起
留得飞花处处忙	迟
梦里身为客	客
何如井邑何	邑
溪山最深处	深
肠断断肠多	肠断
一夜东风结冻云	云
杏花枝上雪纷纷	雪
冰肌玉骨冰肌骨	骨
露洗澄潭照水纹	潭
桃李无花未有花	花
斜阳溪上一溪斜	溪
谁知十载归来处	十载
隔水寒山自一家	山
乐事知多少	少
吴王万事多	王
不知须底事	须
无奈簿书何	书
不见山头月	月
遥闻鼓角声	声
众波千万里	波
若个是曹程	曹
满城春色已萧条	萧条
啼鸟相催过石桥	催
十日好风三更雨	风
青山处处不逍遥	青山
江南陌上麦青黄	黄
又见桃花春水香	桃花
知是春风何处处	春风
行人偏不作诗肠	偏
万事都如梦	梦
归来不是空	空
不知行万里	行
知是越王公	公
佛法从来无诤师	师
钳锤声里不须弥	声
谁知火焰相扶处	扶
正是行行不到时	行
想见江南陌上春	春
不随风雨委埃尘	尘
可怜不是胭脂色	绝色
犹有桃花冷笑人	人
梅花初见小花开	小
好趁晴风细雨来	风
白鸟飞来山静处	山
卷藏不见杏花开	藏
宴罢今朝罢	罢
朝来倦往还	倦
主人归不去	主人
书寄梦中山	书
一事不为予	予
人心终不如	终
不知来此地	此地
犹自读春书	春
春色浑如玉	玉
随风度月光	度
老来非一事	非
惟有梅花香	梅花
独向山中坐	坐
闲来看竹时	竹
铁心铁似铁	铁
何处问谁知	问
从来人物故应难	难
今日归来风更寒	风
落尽落花人不见	人
举头便作放翁看	翁
江南陌上人	人
千年是妾身	身
主恩殊未解	解
何处不伤春	春
满目江山不胜游	胜游
片帆尽日到山头	日
林间鸥鹭应相顾	顾
飞入白云归未休	休
处处有醯鸡	鸡
何人亦有诗	诗
青山与秋草	秋
正是好风时	风
相似不相如	相似
无言道是渠	道
一生虽不死	死
处处有新书	新诗
不作南州路	路
如今是道州	道
不知行路远	远
走马度杨州	度
不知造物故应难	难
万事相寻百万端	寻
满目江山二千里	千里
不知何处不争看	争
园里桃花不见春	春
一花初见一花新	花
落花欲上休吹去	吹
留作孤眠作主人	眠
一室萧然一秃翁	翁
秋风凛凛九天风	风
谁知卧病身强健	身
一片浮云一扫空	空
一树梅花四十春	春
溪山佳处不愁人	人
西园一种千株柳	柳
收得丝丝日日新	丝
明朝骑马出深山	深山
云在寒云满树间	云
老子老来还自学	学
不将心事动清闲	动
万事便牵衣	牵衣
归来十万机	机
老来无白日	白日
今日夜犹归	犹
打破虚空事已空	空
不知高处不生风	高
无端的的知人意	意
争得西来更向东	西
万仞峰头百丈高	高
百年赢得两三毛	十三
从今个个男儿女	女
乞与辽天作怒涛	天
万事有无间	间
万事一时发	发
不知谁令来	令
为我归来晚	晚
孤峰顶上麒麟阁	阁
细草连云带雪开	雪
猿鹤不来天气冷	冷
夜来风月等闲来	闲
一番风雨一番新	新
又见梅花第一根	根
春事自缘无一事	缘
夜深深浅闭柴门	深
迢迢湘水湄	湘水
马蹄千万归	万
不是萧萧郎	郎
一胫惭落晖	惭愧
日日上危亭	亭
秋空第一声	空
归来终日醉	醉
知是故山情	山
百花万里万花开	万
莫向梁间把酒杯	间
莫向白莲舟上去	舟
细看画舫入船来	船
三十年来尚有诗	诗
看来还是雪晴时	雪
世间万事浑如梦	梦
只见梅花雪不知	雪
万事重来不是非	非
如何不得老胡归	胡
老来不作封书事	书
自是无心乐自肥	乐
风雨归来晚	晚
春来事已迟	玉
落花残秉烛	残
不逐乱云飞	云飞
一阵西风立晚风	晚风
轻寒处处颤轻红	轻寒
不知春暖知何处	春
风雨真堪细雨中	堪
凤凰池上雨	雨
走马出骊龙	龙
独向天津去	津
曾来一梦中	曾
昔日登山忆故山	山
旌旗初见一朝班	旗
归来不肯将归去	不肯
只恐天风自往还	风
当时都勘破	破
四海大如海	海
氐丑本无端	无端
广文不为力	文
满地虚空绝点埃	点
谁知孤负不相猜	负
如今不得双双去	双
一步虚空去复来	复
两鬓浑如雪	雪
鸡声到枕前	前
更来三十里	十里
心事自然然	相逢
桃花深处见桃花	桃花
流入青门十万家	青门
佛法不知安乐法	法
夜来无路到君家	君
本来三岛外	岛外
卢舍酒家财	舍
不作山川图	图
湿云随雨来	云
旋旋旋旋旋旋旋	旋
小园开趁蕊珠舡	珠
朝来一阵北来去	北来
些子梅花也可怜	子
山云黯黯万重云	云
万里长空花不分	花
今日归来惟有酒	酒
山中有客问东君	客
风雨落英英	英
朝朝谒帝京	帝
临风向西施	施
归去杜鹃声	归去
冷落河阳漏	漏
兰闺夜月寒	寒
不知天上露	露
霜夜倚阑干	霜
昨夜须弥顶上行	行
从教布被陷人坑	人
谁知贼败人间事	人间
林下犹闻第一声	犹
老来风物自从容	从容
万事谁知造化功	功
手把黄花待春雨	春雨
举头便是老翁翁	翁
临水登山尚尚余	尚
胸中不见玉清癯	玉
如今记得今朝侍	侍
赢得溪山一曲无	一曲
风雨萧萧散	散
春华见物华	春华
不知风物外	外
春雨看梅花	春风
一树无花尚有花	花
解愁处处是谁家	解愁
老来无语无言语	语
满面含羞照碧纱	含羞
不入壶中别有天	天
重来处处著衣然	衣
如今只在江南处	江南
看到绿阴红绿边	绿阴
不到吴山十月时	十月
天门何事且迟迟	天门
老来岂是无情物	物
万事从来实不知	实
两鬓浑如雪	雪
江山带雨来	江山
不知春色胜	胜
飞雪满空台	空
白头三百结	结
天上三千紫	紫
天上酒一杯	酒
诗无一杯酒	诗
初出大江边	江边
此心常不忍	不忍
谁知不归路	归路
明日还丹去	丹
落日又落日	落日
行人不唱时	唱
桥边濯秋水	濯秋水
桥上采花枝	采
昭阳台上古高台	古
昔日沩山僧不来	僧
惟有清谈禅到处	禅
至今犹见落花开	犹
万里风光满太虚	虚
千骑万骑入仙都	万
人人白酒一尊酒	酒
且向尊前不读书	前
竹篱茅屋是谁家	谁家
花落天风日又斜	风
明日归来谁作伴	伴
只应怜见石榴花	怜
昨日重来十日晴	晴
春风何处更多情	春风
桃花满树红何处	红
绿柳阴阴绿太平	绿
溪山佳处且迟留	留
知是高人最上头	人
燕子归来秋已老	秋
故人无语别离愁	无语
十年不得眼中书	书
赢得千林万事疏	林
料得人间无一事	人间
如今已觉满华胥	觉
日日花阴合	合
东南四百州	州
谁知有清处	清
双泪向人头	人
劈箭竛竮竹外枝	枝
争争饶舌不相宜	争
这般饶舌来相唤	呼唤
赢得回头有恨时	恨
细雨归来晚	晚
江南陌上云	云
广文归不去	文
处处有杭君	古人
归来无一念	念
万事与常俱	俱
若得老婆去	老婆
随分一事无	分
万仞峰头百丈高	高
一泓溪水浸寒涛	寒
老来不作长安道	道
犹有飞来秋兔毫	秋
诏诏诏诏诏	诏
君王少圣恩	少
承恩覆车马	马
汉诏与西蕃	西
夜静泉声静	静
清风塞未乾	塞
薰风入金殿	金殿
犹不上龙坛	犹
三十年来不俗尘	尘
世间万事又纷纷	纷纷
不知鼻孔成何事	孔
留得灵山破策勋	破
欲随云影上楼台	台榭
马上看花不敢开	不敢
公子看来成底事	成
高楼独自倚楼来	高楼
昔日重来避俗尘	尘
去年今日又逢春	春
送君相送君归去	君
独对寒山忆故人	山
造物化为底	底
人间小小迟	小
从来好风露	风
不是不呼时	呼
昔日登山忆故山	山
每来沽酒饮衰颜	饮
不知今日将愁去	愁
送与行人愁往还	愁
释氏同心奉至尊	尊
知人应不出朱门	知人
君王自是王王事	王
何苦承恩报圣恩	苦
陌上梅花柳色新	新
坐中宴坐软红尘	坐
老来春事浑无事	浑
造物常持作主人	持
昔日登山忆故山	山
片帆渔艇自往还	渔
如今不踏江边路	路
却向南山买北山	买
顿得归来顿顿奇	顿
鸡声唤得唤来时	唤
谁知不是承天力	天
隔竹从来也不知	竹
自有一砚水	水
飞来花影浮	浮
我来今夜话	话
不是侍儿羞	儿
三十年来尚有诗	诗
如今尚想见青时	青
刘郎独自东归去	郎
应是主翁翁不知	翁
惟有一砚水	水
从来去复来	复
可怜千里月	月
随分上楼台	分
到处是便宜	便宜
看来总不知	总
渠侬家万里	家
不是不疑时	疑
夜深山谷静	静
惊起卧龙眠	眠
啼鸟知深静	深
幽人独宿眠	宿
江南陌上人	人
斜日挂朝衣	衣
却被秋风动	动
雕鞍趁晓归	晓
自有锋铓句	句
先生意亦闲	闲
城中无一事	城中
疑是汉家山	家
绿酒一樽酒	酒
何人相对谈	谈
不知来上马	上马
沽酒买江南	买
帝子重来避俗尘	尘
不知文饰在斯民	民
却疑万事缘何事	疑
不到人间有几人	人
初入武陵溪	溪
桃花月满池	池
可怜湖上客	客
不是惜花时	花
江南陌上彩翚飞	飞
想见桃花到夜稀	夜
惟有落花清到处	清
使君长送野人归	野人
不是晋诸贤	诸
不知贤圣贤	贤
不知何所爱	爱
身物自萧然	身
世事成何事	相违
东风送远人	人
家家牵送客	牵
那得载精神	载
江南陌上人	人
陌上双眼明	明
何处不见君	君
雨中闻雨声	雨
三十年来不记年	年
老来心事亦游然	游
千岩万壑千山隔	隔
应是离人愁不眠	愁
陌上梅花柳色新	新
月光移影到天津	影
老来不得人间事	人间
行到梅花梦里人	行
万事从来不与俱	俱
世间何事只空骓	空
不知是佛谁为佛	佛
却是无边是佛时	无边
百花今已遍	遍
开眼为谁开	蕖
迭竟成何事	迭
闲人自倚来	倚
今日重来不见君	君
不知今日是吾儒	儒
如今二老虽无愧	愧
应是茆堂细读书	堂
江南陌上人	人
江南春色深	深
渠侬是渠侬	渠
不得令侬心	令
栽种庭前树	树
秋来白露秋	秋
老来俱一事	俱
一点点离愁	点
按部笙歌杳不闻	闻
夜来风雨恶离群	恶
祗知春色今何在	祗
玉树已摧无策勋	摧
游人岂不忧	忧
岂谓此身不	身
不见依依前	前
人间人不见	人
北山流水自精神	精神
凡骨何人骨有神	骨
想得溪山护生处	生
隔帘何处是闲人	隔帘
今日重来不见君	君
落花无处不伤春	春
重知春色知何处	重
也与闲人作闲人	闲人
酷暑重来暑气清	清
瓦炉初动碧鸡鸣	碧
若教唤起浑閒事	教
娇拥纱窗听乳莺	娇
处处坚牢落	落
登山倒欲狂	倒
谁知扁舟去	扁舟
应不到家乡	家
池上绿槐影	影
林间绿槐绿	绿
不知风物时	风物
曾见梅花影	曾
三十三分二十分	分
一条垂臂久论文	久
如今独自惭归去	惭
此志青山似使君	志
北风吹向朔风吹	吹
晓气昏昏晓漏迟	晓
说与游人争燕语	争
难教池上看花时	难
风雨令人泣	泣
郊原尚有馀	原
谁知蓟门外	门外
尽日汉家书	日
昔日登山不胜游	游
江山佳处不胜游	游
乱山深处寻山处	山
应是梦中行客愁	梦中
空山明月夜	夜
旋炷一炉香	香
谁识春风处	春风
年来觉梦长	梦
昨日西园一种梅	梅
杏花围绕杏花开	绕
林中只有黄鹂语	语
一夜吹香带雨来	香
一室萧然一秃翁	翁
溪山佳处有天风	天
老来心事须闲事	须
万事都成一梦中	成
王母阶前万斛珠	珠
绕畦细雨细如酥	绕
谁人自是知人事	人
不是经秋不是无	秋
乞与幽人一炷香	香
满枝黄叶染青黄	红
也知不是无花处	花
况是经秋不耐霜	秋
昨夜一声雷雨声	昨夜
关关何事便倾城	关
落花未尽穷愁起	愁
又听秋空第一声	空
老来诗兴动	动
别殿菊花开	殿
只在金炉里	金
夜来人不来	人
明朝骑马到南州	南
不是幡花最上头	花
雨过一江千万里	江
不知郎是一封侯	郎
一雨都无十日晴	晴
乱红红绿十分明	红
重来绿酒一樽酒	酒
细看柳花似有情	柳花
荷叶如荷叶	荷叶
初搴菡萏花	花
犹将离别恨	犹
应笑是谁家	笑
园里桃花不见春	春
北风吹雨甑生尘	生
柴门闭户无人识	不识
惟有漂红是主人	红
黯黯长城月满城	城
清风处处杜鹃声	清风
落花消尽一樽酒	酒
独上西楼看月明	月
百花今已遍	遍
行人不出关	出关
向来无处问	问
不是赵家山	赵
山色秋光暗	暗
山花拨乱开	乱
明明见君子	君子
游子去犹来	犹
天上长安道	道
行人迹已陈	陈
谁知在天地	天
不作贺中春	贺
白石榴花照眼明	明
又随风雨作寒声	寒
夜深一夜听风雨	夜深
细雨飞花渐不成	渐
昨日风光满太虚	虚
他年年有此中书	年
也知今日无他日	日
却向窗前新读书	新
按部笙歌杳不闻	闻
十年相别恨孤坟	恨
如今不到经行处	行
踏破秋空一片云	空
一树无花尚有花	花
夜深不到野人家	家
也知只在江南处	江南
赢得停舟日日斜	舟
千峰顶上黄金谷	谷
百草堂前一树蝉	蝉
不是故人留住处	留
前山疑是谪仙仙	仙
不向山中使	使
归来不得仙	仙
起看山上鹤	鹤
不是主人仙	人间
万仞峰头百丈高	高
煎茶只在掌中遭	茶
向来一笑来谈笑	迎
争得如花两鬓毛	花
归去访东游	访
居人最上头	人
谁知此心在	心
想见故犹愁	犹
不知造物故应难	难
太子谁能为指端	太子
造物自难无一事	难
行人只向日中看	日
不入青山集	集
诸公作鲁公	公
谁知不出处	出处
只在此池中	池
把酒不堪醉	醉
胸中无一声	一声
直至今犹在	犹
无情自有情	无情
短篷江上船	篷
船上青青红	红
酒醒浑未觉	觉
不是愁人风	人
一树无花尚有花	花
壶中有酒是谁家	酒
江南陌上青红紫	紫
知是书生十万家	书生
十年不到五峰前	前
万事锵鸣一坦然	鸣
怪得重来双面目	双
胸中都是旧萧然	旧
百折腰缠十万钱	万
悲风不动更凄然	不动
归来多少留春雨	春
还似襄阳旧少年	旧
十年不到五峰前	前
一念重来一念然	念
潮汐往来无觅处	问
不知元是是无边	元
落花今不记	记
吹雨落花风	风
记得归来久	久
秋天细雨中	天
青山无路不堪行	行
自是还家不计程	家
况是人间有新雨	新
隔花时听杜鹃声	花
渺渺江山远	远
西江一树秋	秋
夜来江上雨	雨
万树大江头	树
一树无花尚有花	花
小园旋摘紫金芽	金
六宫乞食缘何事	宫
不是寻春不到家	春
打破虚空事已空	空
身心只在浮云中	浮云
老来不是人间事	人间
到得归来意不穷	意
一番风雨一番新	新
到得凉生是早春	凉生
料得荔支今已老	支
鹭鸥何处是闲人	鹭鸥
礼乐谁为乐	乐
无多少少情	少
官闲无一事	闲
应笑太平生	笑
一树无花尚有花	花
不知春色在人家	美人
愁人不劝人归去	人
一枕重来日日斜	枕
万事从来作麽生	生
出头归去不成行	行
普门透出花开处	门
尽是幡花第一声	花
为政无为政	政
今为社稷臣	社稷臣
馀空无一事	空
岂是不归人	人
旧事无人问	问
江梅欲雪时	雪
太中无一事	太
应是向西施	施
纷纷初见菊花开	纷纷
明日还家万里来	家
冰雪满空归不去	空
东风尽日送春回	日
千树花开柿叶红	红
百花千树绕秋风	绕
也知春事偏长短	短
不与梅花作好风	风
明日未还家	家
清阴看落花	清阴
不能知有圣	圣
且学种桑麻	学
风月在尊前	前
同心奏广文	文
不将书字字	书
何事不劳言	劳
三十年来别有情	情
一樽无酒更无情	酒
江南江北多风雨	江南
寄与梅花寄别情	寄
一树桃花满树红	红
不知明日又春风	春风
不知处处垂杨柳	杨柳
只种杨花浅草中	种
归去重来不见君	君
满天云水满山云	云水
酒醒酒醒还归去	酒醒
明月满空山又曛	山
已怯东风柳眼青	青
老来无事足伤情	足
可怜陌上多寒雨	寒
惟有杨花复旧情	复
平地波澜翻	翻
风波不入山	山
夕阳台上翠	翠
屏障出云间	障
青灯照秋月	秋月
青灯照白日	白日
夜来秋色空	空
寒山对秋月	山
青山无处觅	觅
马上三千骑	骑
东南与南北	南
今日为君归	君
无心听不彻	彻
安得镜中秋	秋
枕上知何许	许
无心月自流	月
北风吹作朔风吹	吹
小队旌旗斗酒旗	斗
不是凤凰池上客	客
流莺桃李及春时	流莺
一舸乘风入楚云	云
坐中还向坐中闻	坐
风帆一阵天风起	风
信手抛来掉臂分	折来
一树梅花四十春	春
白头白发白头新	头
马蹄踏断桥边岸	岸
却是落花愁里人	愁
春色浑如玉	玉
单于陌上行	行
胸中无一咏	咏
援笔寄关情	寄
杜老似当年	当年
不见城边草	草
不知今日来	今日
白发垂垂泪	垂
日日初长日	日
东风尚好风	风
谁知有遗庙	遗
瑞麦战场中	麦
按部笙歌杳不闻	闻
广寒宫殿拥寒云	寒
宫人不唱歌声曲	声
却被愁生恼杀君	生
不入武陵祠	祠
灵光现千里	现
安知不是空	空
此心千万里	心
金钗宝髻髻金钗	髻
梳发罗裙锦绣鞋	发
侍女莫嫌儿女伴	伴
西风吹著紫金钗	吹
仓皇习气旋旋旋	旋
水口风光亦自然	水口
今日舟行千万里	行
扁舟急急上渔船	急
堂上一株松	松
阴阴又一冬	夏
山头头月白	头
传语雨声中	语
古今古	古
今不遑遑安	安
不是可讥人	人
自有讥空名	空
北风吹雨泣东风	东风
只在孤云一片中	一片
落尽落花人不见	人
一帘飞雨落花红	飞
山光凝不流	流
木落一花发	花
处处是春风	春风
春来只愁绝	愁
云山深处是吾庐	庐
顾我清斋更读书	清
记得归来犹健在	犹
也曾携笔记游鱼	曾
归去归来未肯归	肯
酒船沽酒泪沾衣	酒
落花不断行人眼	眼
泪尽心随柳絮飞	心
杏园初见杏花开	烂
不是荷花细雨来	荷花
蝴蝶不愁人不去	人
群林惟见杏花开	群
岂不识人意	意
青山白云合	合
故人如许来	许
特地添秋雨	添
飞向江南陌上行	行
不知秦汉故人情	汉
君王自有承恩力	力
应念君王念世情	念
已怯东风衮衮衣	衣
朔风吹雨到天稀	天
梁间车马知多少	间
赢得孤眠不得归	眠
万仞峰头百丈高	高
胸中长短又周遭	短
胸中自有些儿辈	儿
拄杖相扶亦不遭	扶
一夜东风六月寒	寒
闭门相望眼明宽	明
也知只在山深处	山
折得梅花绕树看	树
白发年华发	发
工夫岂不知	工夫
此堂无一事	堂
折得一一枝	一枝
昨日归来三载酒	载酒
无人为我一篇诗	诗
送君到处君知否	君
便是墙西三月时	西
一事不须须	须
安知不是郎	郎
完全无一事	全
心事也须忙	须
百年虽壮岁	岁
终日舞秋风	舞
莫向山头挂	挂
将行到坐中	行
秋风凛凛九天风	风
极目诸宽更不通	诸
今日重来还有道	道
萧萧萧在寂寥中	萧
万事重来不是非	非
青灯照眼倍增明	明
老人愦愦真堪笑	笑
勘破题诗亦有情	破
一路浮云万里行	行
从公天上最先生	公
老来不是依前事	前
看得几多自有情	几多
百尺孤帆挂戍楼	挂
隔山不见故山流	山
孤帆到处无寻处	寻
桥下呼童上钓舟	呼
万事重来不是非	非
丫头宝剑一双飞	双
元来不是元何处	元
不是峨峨不得归	峨
画戟祥云跨彩鸾	鸾
北山安石对南山	石
如今不是呈金处	金
说与行人叹往还	叹
落叶萧萧似草庐	萧萧
小窗清夜读诗书	清
老来不作推窗梦	窗
不觉人间万事无	人间
两鬓浑如雪	雪
谁知屋屋间	屋
不将书字字	书
不是寺中山	寺
渡头无一线	一线
半是路傍人	人
不到诚斋处	斋
归来尚尚新	尚
自有一砚水	水
云山能叠叠	叠叠
山头秋月明	月明
秋山对秋草	秋
不作留人意	意
伤心自爱时	爱
夜来江上梦	梦
不悟故人知	悟
瞎驴走马访刘郎	郎
三拜重来二十郎	郎
自是周郎无一事	郎
如今应是一刘郎	郎
三百年来事不穷	穷
又闻吹雨更悲风	闻
世间万事非何事	非
都在明年一梦中	明年
不见枝头一叶红	红
一枝端欲诉天风	天
何时折得归来偶	偶
只在寒云细雨中	云
夹堤杨柳绿槐绿	绿
啼鸟衔花上苑花	花
旋种绿杨堤上树	树
离愁犹恨在人家	犹
不是无花未有花	花
行人行不到天涯	行
从来白日长相对	相对
只在人间十万家	人间
一树梅花四十春	春
百花无雨净无尘	雨
墙头绿柳千株绿	绿
蝴蝶双飞作主人	飞
夜泊孤舟古岸傍	傍
巴山流水一牛羊	茅
桃花隔水随人去	人
为我哦诗忆故乡	诗
不见山头月	月
飞来九月天	天
一篷今夜雨	篷
身是钓鱼船	身
废兴废兴废	废
论兵犹尚书	犹
瞎驴坟上冢	驴
老幼相亲书	相亲
不入神仙洞	洞
人间竹洞房	竹
往来无人识	识
千里出襄阳	千里
夜来风雨不胜秋	秋
一夜孤吟独上楼	吟
一夜梦中俱一事	俱
西窗一夜读书愁	书
柴门终日掩柴关	关
更有行人路往还	路
记得归来分到处	分
从渠处处见青山	渠
三十年来尚有诗	诗
从来何事更希夷	夷
只今惟有长安乐	乐
正是登山临水时	临水
万事无从事	从事
狂风拍拍来	拍
只在云烟里	云烟
还惊去不回	惊
昔日上羲皇	皇
乾坤无尽日	日
昨日纳些儿	儿
相争独无语	争
乞与幽人一炷香	香
不知何处是虞唐	唐
老来自觉人心静	静
记得归来岁月长	岁月
池上千竿竹	竹
江头月影寒	寒
山中有消息	消息
不用到长安	不用
三十年来尚有诗	诗
从今掺别别离离	不离
自从门外辽东去	门外
正是舟行无尽时	行
不见山头月	月
吴山寺里花	花
春风何处处	春风
何处不还家	家
岩下长安石	石
登山道路通	通
从来勤一事	勤
处处有新风	新
万事从来天地平	平
江南陌上柳青青	青
此翁归计知何处	翁
时泛扁舟过此亭	村
不挽车轮转	转
回头见雁回	雁
夜来天上雨	雨
不见此花来	花
岩上一株松	松
不复今无复	复
何事不相亲	亲
行人不教去	教
麻衣不着六铢衣	衣
岂是吾心自有期	心
四十年年无一事	年年
我来看取立多时	取
绿酒一樽酒	酒
西风吹落花	吹
可怜江上客	客
飞上紫天涯	紫
敏手不入手	手
从来聊自来	聊
从来今不拟	拟
那得广文开	文
红尘污不污	污
五十去年长	五十
旧事无人问	问
他山旧道场	山
万里清风委俗尘	尘
梦中曾是见游人	曾
此时莫向岩头去	头
解与西山作主人	解
从来春事已分明	分明
折得梅花一样轻	轻
不是鸣梭无到处	鸣榔
此心到处是先生	先生
昔日谢苏公	公
至今夕阳日	日
故人为客来	客
今日空日日	空
一树千株碧	碧
梅花一炷香	香
西湖花影里	西湖
唯有梅花香	梅花
不见山头月	月
归来水上船	船
夜来清未晓	清
春水绿悠然	绿
羽籥重来二十年	十年
不随云驭更凄然	云
谪仙不是呈金处	金
留得天香上九天	天香
万事从来不是良	良
从来不为尔为强	尔
一生作计终难事	难
处处方知是故基	基
云山叠叠叠家山	叠
清气虽清亦自闲	清
为问溪山无著处	问
更无踪迹在平间	正平
太液池边柳色新	新
天光莹莹益精神	益
游人不识苏公意	公
空与君王作主人	空
走马驱车马	马
胡床卧卧床	卧
百花千万烛	万
知是越王郎	郎
北风吹作朔风吹	吹
南北东南尽日迟	日
广陵今日无人见	无人
正是春风风雨时	春风
宝髻云鬟笑脸横	横
昭阳台上露华清	清
胸中自有神仙掌	仙掌
更有何人愿此生	愿
令人不识心	心
那得自工心	工夫
若不知君意	君
从来不可寻	寻
吴王宫殿锁烟霞	锁
独掩关关日日斜	关
疑是洛阳台上客	客
从兹不见石榴花	兹
江南陌上人	人
陌上草成茵	成
不是长鲸窟	三窟
安禅柏子房	禅
秋风凛凛九天风	风
已挫愁人淑气中	人
猿狖最知奇绝处	最
北风吹雨看春红	春
三十年来尚有诗	诗
至今谁料理新丝	新
老来何事无人识	识
啼鸟自来人不知	人
父子慎谨慎	慎
其诚何所存	怀
羲之犹所憾	犹
而乃古而存	古
一望吴城九陌头	头
夕阳城上听鸣驺	鸣
山深处处无人识	识
只有江山号故侯	号
功成败绩几经秋	秋
一望黄河血尚流	尚
不是元戎征战血	血
人间何处是诸侯	人间
独向阶前醉脸横	横
小楼寂寂悄无声	寂寂
人人尽向山中兴	兴
更欲凭天看月明	天
江头十日又春风	春风
漂泊扁舟到客中	客
明月未甘春水冷	甘
短墙如雨雨濛濛	墙
昔日登山忆故山	山
武陵桥上夜凭阑	夜
回头望断千山暗	暗
不与愁人着眼看	人
诏诏重来寄此身	身
故人知是汉功臣	汉
不知胡败成何事	胡
若使还家是主人	家
不露一时露	露
窗前草木香	窗前
春风何处处	春风
都在水云乡	无心
昔日登山忆故山	山
只今归去又春还	春
欲知春色今犹在	犹
为问游人自往还	问
日日赛嘉宾	宾
种得螟蛉种	种
不能费主人	费
盗跖为人笑	人
临水青山似辋川	川
北风吹雨饱风烟	风
落花草木谁相倚	倚
留与幽人作夜眠	夜
老来何事太匆匆	太
试向街头试角弓	试
好与使君同一股	茹
诗人犹自有诗穷	诗
三十年来一老卢	卢
骑驴走马走轻涂	轻
如今一掬溪头水	水
不是昔人曾也无	曾
不露一时露	露
春深意转深	深
春风乍晴处	晴
家处不伤心	家
不露一时露	露
梅花半坠腰	腰
可怜阶下草	草
全是折长条	全
青山只在水边头	头
只向青山处处游	游
自有游人归骑去	骑
不将风雨写离愁	写
一树梅花四十春	春
眼前花是旧时人	花
如今老子知多少	少
又是东风又早春	东风
昔日谢苏公	公
今年忆鲁公	公
一春天上雨	春
都在此行中	行
明朝骑马到南州	南
南北河清渭北流	清
知是毗耶江上客	客
无人还见别离愁	无人
乔木森森森绿野	野
森森乔木晚生寒	寒
陌头柳色知何处	头
终日倚栏终日看	终日
百花如锦绣翚飞	飞
宫女归来未解时	解
却向桃花儘深处	深
桃花帖水满瑶池	水
细雨出长干	干
聊将细细看	聊
不知三更漏	漏
老子报平安	老子
姑苏堤上千株柳	柳
一种桃花柳色新	新
昔日谢公归不去	公
不知何处有诗人	诗
帝子重来避俗尘	尘
客星稀处见星辰	稀
山头春色浓如蜡	蜡
风味清香不恼人	风味
百年只在此山中	山中
纵使群来迥不同	群
料得仙都在城郭	城郭
青山都在白云中	白云
礼乐谁为乐	乐
何人骑鹤归	鹤
北山虽不负	不负
风月满窗衣	窗
不得安心法	法
不是无非聋	无非
不得安心法	法
不将佛法通	法
自有一砚水	水
谁知佛祖风	风
山头秋月白	红
只傍绿阴中	傍
不见梅花开	梅花
飞来故故交	交
梅花总憔悴	总
玉笋出花梢	盆
西去西来十二吴	吴
不知秦汉故应无	汉
如今不是将军事	将军
日日看山人亦无	人
绿酒一樽酒	酒
一杯金满卮	金
不知身止酒	身
欲折看花时	折
送客能留客	留客
诸贤是主人	诸
会须无一事	须
何事不随分	分
十年不到五峰前	前
又见梅花几许愁	愁
唯有游人故相忆	忆
蓼花深处卧孤舟	卧
老向山中忆少年	忆
白云归去月依然	月
至今天下无鸿雁	鸿雁
应有书生死别篇	死别
白玉堂前一种梅	梅
梦中闻道雪花开	道
归来最是伤春处	春
留取堂前一种梅	梅
不得清幽怨	怨
幽花独自芳	芳
落花开一片	一片
疑是一时凉	凉
从来处处是公家	公家
每向清斋阅岁华	清
不是世间真隐隐	隐
向人深处种桃花	人
燕子归来事已残	残
斜风急雨倚栏干	雨
行人莫作披襟看	襟
安得闲身独自安	身
天下昔曾闻	曾
归来不见言	言
斯文殊未解	解
不教不能言	教
蜀山岩上一株松	松
急雨萧萧对晚风	雨
吹尽落花人不见	人
北风吹雨动秋风	动
乔木森森森夏木	木
石床凉簟怯新凉	裳
谁知独上无楼处	楼
风雨吹成秋夜长	成
一窗风雨泻檐声	声
卧听风窗听雨声	风
一枕西窗书枕梦	书
鸡声唤起枕边城	墙
主人到处不知名	知名
谁识胸中酒有情	酒
说与故人争一事	争
梅花处处有诗情	梅花
十年不得眼中书	书
翰墨重来墨不如	墨
记得百年香案吏	吏
老来长记读诗书	记
万株杨柳护春风	春风
都在琼楼日暮中	日暮
明日倚楼人不醉	人
杏花深处石榴红	深处
昔日登山第一登	登
谪官又得一官登	官
如今不到天台夜	夜
忽见飞来一老僧	忽
身是当年一病身	身
红尘满眼委埃尘	尘
傍傍草木知何处	傍
不见梅花有几人	人
江南陌上人	人
东去复南陌	复
不见朱幡胜	胜
撑空二千里	空
空山明月夜	夜
一夜明朝雨	雨
枕上一扁舟	扁舟
炎热浑不减	减
佛法从来不自修	修
举头云气不回头	云气
棒头入眼谁人识	人
放出片云不点头	片云
千年翰墨画难成	成
尚有馀香画不成	香
老子老来无限思	思
也知到处是郎情	郎
百尺竿头十万竿	竿
天津桥上带斜看	斜
不知桥上无人处	无人
白鹭飞飞万里滩	飞
欲去归来更不疑	疑
老来心事不知非	非
人间万事非何事	非
独泛扁舟载月归	月
不入龙门洞	洞
重来一窖尘	尘
今无些子子	子
不是不归人	人
不知谁是与刘郎	郎
又见南山急雨长	雨
记得到家缘底事	家
古来何事付刘郎	郎
一曲溪头燕颔须	须
伯仁心事不知无	仁
而今此去无消息	永
更有何人爱五湖	爱
淑气已如云	如云
和气一朝罢	罢
不议王子猷	议
谁知一亭下	亭
多病常多病	病
能知有几人	人
归来无尽日	日
何处不伤春	春
三十年来也未曾	曾
不知何处号鸣筝	号
老来万事还相逐	逐
三十年前旧姓名	旧
天上谁为指	指
行人不为群	群
故人犹自在	犹
犹自不为邻	邻
日日初长日	日
丰隆暑气微	微
乐天偏日日	偏
如水雪花飞	水
行人亦可怜	怜
岂是圣贤贤	贤
相逐将归去	逐
谁知不在前	前
令人忆昔时	忆
百百不堪悲	百
万事今犹在	犹
佳人在此时	佳人
黄金不涌金	金
飞入新诗里	新诗
春事已三年	三年
先生此时节	先生
江南陌上野人居	居
万里惟天不读书	天
携手自持携酒去	自持
醉中流出水中鱼	慢
不是维摩手	手
从来不相见	相见
只在此山中	山中
前头一花发	花
杨柳溪头陇麦黄	黄
北风吹雨百花香	香
白头日日相牵去	牵
一点黄花带夕阳	一点
不知谁是与刘郎	郎
便作东风古道场	东风
纵使刘郎无到处	郎
西风吹泪落天香	落
忽闻天上雨	雨
处处鸣鸠鸣	鸣
一雨画不成	成
无人还有酒	酒
惟有溪边竹	竹
春来意亦深	深
落花开夏木	木
谁识识人心	识
马上黄金鞍	金鞍
风清晓气清	清
开门对秋水	秋
不应听鸡声	不应
一树黄花挂荔枝	挂
山头紫翠最多时	翠
不知何处拟归去	拟
万事从教都不知	教
昔人虽不愿	愿
不自不持持	不自
自从今日出	日出
煌煌煌煌时	蟋蟀
长忆西湖处士家	家
不知今日又横斜	今日
一天自是无闲事	一天
小雨催租看落花	租
姑苏堤上千株柳	柳
一夜东风久雨来	久
攀折落花谁忍折	折
别来相望为谁开	怅望
万事从来作麽生	生
回头又得一时晴	晴
脚头失脚拖云去	云
走马冲泥走马行	马
夜来风雨到严陵	陵
知是江南第一僧	僧
老子老来浑底事	浑
落花初放上层层	放
不入壶中别有天	天
风光不挽本茫然	挽
老来不得追凉处	凉
一别魂清又几年	清
酷暑重来暑气清	清
老来魂梦不曾曾	曾
一床一榻茅斋罢	罢
卧听空斋半夜灯	空
十年不到五峰前	前
今岁秋空一坦然	空
准拟从来隆准拟	拟
涌金毛颖拥炉边	金
洞口归来只有鱼	鱼
不知端的信应无	信
自从到处时闻说	闻
自谓邻翁不是无	翁
打破虚空事已空	空
百花百草不相同	百草
此身自是无身处	身
踏破寒潭万里风	寒
昔日游山不胜游	游
醴泉流出大江头	江头
令人记得閒心事	心
说向青山卒未休	休
老去归来今几年	几年
一炉香冷更凄然	香
居人不问人何事	人
且借僧窗尽日眠	日
一阵东风作好风	风
朔风吹雨冻云空	云
看来不是宜时节	宜
日日相呼细雨中	呼
太液池边柳色新	新
落花千里不愁人	人
吴王陌上游游处	游
不见桃花莫笑颦	笑
群鸦飞上苑墙东	东
记得春归春梦中	梦中
今日归来书不断	书
北风吹雨落花风	风
谪仙本是老逋仙	仙
谪在人间百姓前	前
万树落花无尽处	撒
不教到处是长年	教
此去西来更有无	有无
桃花深处见红萸	红
如今雨打梨花去	梨花
记得归来旧里无	旧
万事有无间	间
临风怯远山	怯
一声春梦里	声
醉眼几时还	醉眼
临水登山处处求	求
寥寥寥落水中秋	秋
胸中惟有孤船子	子
忍听行人听客愁	忍
小小姑苏小	小
梅花也未须	须
老来成底事	成
为主自清癯	主
天上长安道	道
今从游子归	游子
可怜堤上柳	柳
空泪满鹑衣	空
今年十日未归来	归来
万户千门掩绿苔	掩
料得完全无一事	全
至今犹见落花开	犹
燕子归来一炷香	香
百花深处有流光	深处
与君归去知何处	君
莫怨东风欲断肠	东风
魏帝城边百尺危	危
何曾乐府是何时	何曾
望断断肠都不断	不断
绿杨深处有深碑	深
临水登山不可寻	寻
托根景物照人心	根
谁知不是菩提处	菩提
鼻孔辽天到夜深	天
两岸黄花竹绕篱	绕
卷帘开户便褰帷	下帷
游人不得相欢喜	喜
却是溪头艇子时	子
风雨恼人常不睡	睡
百年松上万年枝	松
逢人试问人何事	人
正是旌旌万里时	旌
寥落浮云散	散
清风暂暂开	暂
游人唯不见	唯
不见马飞来	马
乳燕归来春意深	深
黄鹂无语语伤心	语
梨花不是飞来雨	雨
满树梨花满树阴	春树
隔水骊山拥鼻观	观
懒烧芳烛更阑珊	芳
如今不见池边柳	柳
不敢将诗细细看	诗
遗恨不堪恨	恨
相逢不遇时	遇
别来今白发	白发
那得到家知	家
百年和气在东南	东南
不见梅花谢半酣	谢
料得从来伸喙吻	誓
史臣狼籍在东南	史臣
天上长安道	道
江南陌上春	春
内家携手手	手
一夜发精神	发
万事不为勤	勤
岂为何人种	种
何人为尔来	尔
憔悴不容易	易
白玉阶前一树阴	阴
每逢佳处不难禁	难禁
老来十日无余事	余
自有闲人有此心	心
独向孤峰顶上行	行
又随流水绕山行	山
溪山处处无人识	识
试看青山过一生	试
不入汉河汉	汉
月明河汉清	清
出门无人见	无人
不见月华清	清
真实不为诚	诚
更无些子子	子
不知别有天	天
天中有明月	明月
旧事无人问	问
山中酒更赊	酒
平生草生处	生
惟有命黄花	命
昔日登山忆故山	山
寥寥何处绝尘寰	寥寥
近来人物应难事	难
那得从容与我閒	容
昔日登山忆故山	山
老来何事不相关	关
洛阳陌上青青紫	紫
犹胜今犹半日闲	犹
栽种庭前树	树
花枝玉树春	春
梨花枝上雪	雪
千树拥寒云	云
一阵西风暑气凉	凉
案头香火瑀修篁	修
游人莫向山头话	话
只有梅花一炷香	香
洛阳陌上送行人	行人
不逐东风过雨尘	雨
今日武陵江上路	路
未应容处见游人	容
故国归来自有期	期
此情何不肯同时	肯
明朝细雨归来晚	晚
又见江山似旧时	旧
姑苏堤上千株柳	柳
杨柳黄花泪满衣	衣
惆怅别来愁别恨	愁
江南风雨送春归	江南
不见枝头一叶红	红
秋来更有一般风	风
大千世界无人指	指
洗得从来眼界空	空
垂钓扁舟系钓船	钓
柳丝扶疏故依然	疏
重来一日好风雨	风
只在桐江二十年	江
万事从来事不殊	殊
老来何事不关渠	渠
莫言一语无言语	语
不是闲身不读书	身
年来宁复复	复
不复为谁云	云
如此化为佛	佛
如今旧使君	旧
三百年来事不穷	穷
至今留在此山中	留
年年记得新年事	新年
更觉今年胜梦中	胜
风月在尊前	前
虽佳亦自然	佳
不知天上露	露
还是月明天	明
万事一开颜	开颜
何人学破颜	学
墙头秋月白	红
流水漫青山	漫
昔日登山忆故山	山
如今西去又吴还	吴
如今不见行人眼	眼
只有亲曾到此间	曾
平生万事太平生	平生
百草黄花各自黄	黄
今日谢公知有意	公
此中惟有一般香	香
日日初长日	日
西风步月迟	月
欲知春尽处	春
啼断落花时	断
太液池边柳色新	新
朱颜宋玉奉王宸	玉
君王宣赐金尊酒	酒
特赐君王赐圣人	烦
三十年来也未曾	曾
举头更上数层层	数
行人莫笑低头笑	笑
不是人间不可憎	人间
溪山佳处且迟留	留
满眼看来总是愁	愁
料得归来三殿里	月殿
百花如锦不回头	锦
白发垂垂泪	泪
胸中万卷书	书
春风不到处	春风
处处见春鱼	春
日日初长日	日
亭亭日日留	留
行人不相寄	寄
缘底不回头	底
岩上一株松	松
无春尚有风	春
不知无物物	物
只在翠屏中	翠
江南烟水中	水中
独向山中记	记
有鱼不得鱼	得鱼
一半橹声起	一半
胸中惟有一毛锥	毛
积涝初收不起时	收
若使诸贤无一事	诸
为渠渠自有新诗	渠
青山犹自昔曾来	曾
慷慨悲歌亦在哉	歌
回首休言有遗恨	休
如今记得几时来	当时
日日上危亭	亭
水边栽一茎	栽
我师殊有意	师
独有谢公情	公
绿酒一樽酒	酒
西风秋夜寒	寒
游人不得睡	睡
安得自平安	平生
一树无花尚有花	花
绿阴深处翠横斜	翠
重来枕上无书处	书
烟鸟穿林噪乱鸦	烟
自有一砚水	水
一仿佛祖风	风
枕上更无人	无人
独卧白云中	卧
天上长安道	道
黄河万里流	流
不知非一事	非
应不属苏州	属
一种荼醾压众芳	芳
百花如锦绣花香	绣
老来不被红尘扑	扑
蝴蝶飞飞粉蝶忙	飞
江南陌上人	人
杨柳不伤春	春
昨日将书去	书
看花似故人	懒
老来何事不关渠	渠
树上归来亦有余	树上
燕子归来霜已老	霜
剪裁青玉镜中书	玉
太白鹅黄柿叶红	红
满头霜月浸秋风	月
也知不是横斜处	横斜
只在分明境界中	分明
流水登山不可寻	寻
北风吹雨湿云心	云
十年不入山间路	路
却向空山扫石深	石
满目江山似昔年	昔年
不知今日又潸然	今日
老来自有知人意	意
万事从教一坦然	教
燕子归来春意深	深
故园杨柳已成阴	阴
黄莺飞去燕飞去	飞
风雨杜鹃声里心	声
赋罢梦难成	成
无言意转深	深
当时携手手	手
知是玉关心	玉
胸中多气魄	气魄
小作小嶙峋	小
铁笛一声里	一声
不知三日人	三日
一枝攀折向南枝	南
一叶漂红有几时	红
万事不随行路隔	隔
乱山深处有新诗	山
群鸦飞上苑墙东	东
都在东山入梦中	东山
记得招提相别处	招提
白云飞上白云风	白云
万事从来作麽生	生
此心期处是虚明	期
要知一点无心处	一点
岂是无心弄一声	弄
十年不得眼中书	书
岁月安心事不如	岁月
更有谁家数椽笔	笔
何人知是故人居	居
身是当年一病身	身
好风风雨委埃尘	风
老来旧事真堪恨	堪
不是梅花一笑人	人
今日重来不见君	君
不知天上帝如云	帝
此中况是知何处	况
二十四时俱不闻	俱
当年丹芍药	药
不作杜陵诗	诗
今日花如雪	雪
不吟明月时	吟
归来处处有清风	清风
只在高楼小阁中	小
猿鹤归来今已久	久
能来何处不相同	能来
秋水平如镜	镜
湖光射月光	射
夜来空画里	空
物色是非光	非
身是当年一病身	身
老来心事一时新	新
如今不见山头碧	碧
又作千山万里春	春
万仞峰头欲插天	天
北风吹雨落江边	落
欲知此物无聊赖	聊
此水有山山自然	山
西风凛凛九天风	风
半在清溪细雨中	溪
待得溪头花白发	花
归来应不是吾宗	宗
昔人今不记	记
闻道昔人稀	道
自古无人学	学
今从何处吹	吹
南北东南北郭茔	北
登山准拟筑长城	拟
闻闻闻说南朝事	闻
愁听穷愁听雁声	愁
处处是渔灯	渔灯
梅花慰牢落	落
不随烟雨来	烟雨
只在双峰里	双峰
江南陌上野人居	居
把酒看花意不如	意
江北墙西无觅处	西
却将诗寄梦中书	诗
物情尤物物	物
造物已成川	川
惟有山头月	月
千岩万壑然	万壑
礼乐谁为乐	乐
归来不是秋	秋
萧萧萧郡郡	萧
不饮别离愁	饮
中有幽人一炷香	香
梦中犹有此花香	花
看来自是无闲处	闲
镜里飞来日月长	镜
陌上笙歌舞	舞
珠帘雨露寒	寒
卢童弹一曲	童
流出涌金盘	金
折得清风一葛藤	藤
故山苍翠上层层	山
归来处处长相忆	忆
夜半猿声到广陵	夜半
缟裙练帨映烟霞	映
影落斜斜花影斜	落
独倚西窗听秋雨	秋雨
傍人风雨看梅花	人
春色已分明	分明
村西第一声	西
会须缘底事	须
应不见君情	君
十年不到五峰前	前
想见行人意豁然	意
今日归来江寺里	江
不知人去几千年	人
打破虚空事已空	空
棹来一棹月明中	棹
无端的的知人意	意
争得回头是大虫	虫
江南陌上人	人
万事纷纷竞	竞
终日殢春风	春风
只在清影里	清影
昨日重来蜀锦囊	囊
今年春事自忙忙	忙
桃花陌上看秋雨	秋
一树桃花竞隔墙	竞
万里秋光满夕阳	夕阳
百花飞尽紫霞觞	飞
游人莫向山中宿	宿
今日还曾到夕阳	曾
一跌浮云万里行	行
北风吹雨入山行	山
古来门外知何事	门外
只隔南州第一声	隔
草色连天迥	迥
清光出世尘	世尘
不知天上月	天
知是故山人	山
稚子金黄金叵罗	罗
蓬莱午枕梦中多	蓬莱
月明一夜深风雨	深
燕子觉来羁客多	客
天上一齐梁	梁
西来是道场	日
可怜陌上女	女
流水度青桑	度
万事有无间	间
岩头与北山	头
摩挲无一事	摩挲
起舞几时还	舞
北风吹雨泣西风	西风
今日思君一梦中	君
流水落花无限意	意
落花江上早春风	早
老去归来事已先	先
好风吹雨更凄然	风
明朝又向残阳去	残阳
一树青红是几年	红
万事重来不是非	非
不知儿辈自风流	儿
老来万事空无事	空
只在南山最上头	头
从来万事不争先	先
料得身心犹自然	犹
饶舌本来无一事	太
此心犹自注诗篇	注
绿酒一樽酒	酒
令人把酒杯	解
梅花又生酒	生
又向赵州来	州
昔日登山忆故山	山
遗沟宛在水中间	沟
归来山去知何处	山
隔水青山总往还	总
一舸乘风入楚云	云
落花千里别离愁	愁
归来不是思归客	客
借我扁舟坐白头	坐
东南南北各东西	东西
西望芜城路不齐	城
马上何人听吹笛	何人
一声秋里听猿啼	秋
蝶乱莺花乱	乱
青青草树青	青
落花犹带雨	犹
风雨涨新亭	涨
万事从来作麽生	生
老来强作百年强	强
如今马上三千骑	骑
不是当时俱自忙	俱
惟有溪边竹	竹
归来夏亦凉	凉
夜来池上雨	雨
幽鸟入幽房	幽
一望青山不入山	山
不随云气出云寰	云霄
我来且与登山约	约
欲扣孤云自往还	扣
昔人常不受	受
今为化为子	子
胸中有客来	客
欲访戴将去	谒
长忆西湖处士家	家
羡师春事自参差	师
我来杖策勋名处	名
遗在青山自一家	遗
洞口归来只有鱼	鱼
满庭木叶满簪裾	庭
不知日日随人去	人
留作南山尽日书	日
绿柳千株绿	绿
千花万树红	红
中庭何处处	中庭
都在树阴中	树
欲去又重来	重来
经年拨不开	经年
不知君会否	君
不为何人来	何人
不随车马走	走
白雪满林林	林
只在山深处	山
不知春意深	深
初入武陵溪	溪
山花画如画	画
处处有荷花	荷花
归来亦无数	无数
燕子归来一炷香	香
百花飞尽紫霞觞	飞
不知春色今犹在	犹
眼底梅花欲断肠	底
春风细雨杏花繁	繁
攀折残花托返魂	托
不见故人成别恨	成
拍天流水隔重门	天
天上更无人	无人
惟有惟相亲	惟
无心惟有酒	酒
不是声中人	声
北山归去杳无踪	踪
无迹登山不见踪	迹
陌上行人还自笑	笑
云山都在石千峰	石
岂不知人意	意
还知夜漏迟	夜
可怜江上客	客
不是卧多时	卧
今日重来不见君	君
迟看陌上别离群	迟
如今二十二十二	第二
今日重来诗送君	诗
园里桃花不见春	春
黄梅恰恰恰新新	恰
春来物色浑无数	数
细雨落花愁恼人	愁
踏破阶前竹	竹
登山忆故山	山
江村何处处	江村
郎不在人间	郎
此去重来有几人	人
幽花处处见幽春	幽花
如今四海知何处	四海
安得重来不得亲	亲
何事谁能慰我怀	怀
老来何事又还家	家
行人且喜无欢喜	喜
折得清香更有花	有香
蒲团枕簟送新凉	蒲团
闭户珠帘白昼长	闭户
到得风光方莹彻	彻
月移花影透寒香	寒
万事事难成	成
心中有此身	身
不知三世俗	俗
不是思他人	思
胸中无物物	物
不见落花飞	飞
岂是宽宽地	宽
胸中第一机	机
按部笙歌杳不闻	闻
汉宫歌舞解祥云	解
西风吹破吴王梦	梦
不是君王是妾心	心
江北江南九月天	天
千岩草木亦苍然	岩
故山猿鹤知何处	山
唯有梅花在水边	水
夜来风雨更凄凉	凄凉
惟有猿声苦更长	苦
流水落花无处问	问
不知何处有修篁	修
日日初长日	日
无人更有人	无人
相应无一事	相应
谁是不归人	人
千古佛法妙	妙
一体玉无瑕	玉
拈来不是空	空
板桥自出家	板桥
碧纱窗下读书窗	窗
乐事真堪事可伤	堪
惟有游人不相报	报
谁知枕上有新凉	枕上
岂无一事若为谋	谋
故国由来命亦轻	轻
休叹人间有遗恨	休
不将双泪向淮流	流
串串黄金铸紫金	紫金
双双袖手自伤心	手
老来不拟将将去	拟
翻及梨花一夜深	翻
燕子归来渐渐稀	渐
隔帘香雾尚沾衣	香
夜来风雨忽惊起	忽
独自有诗归未归	诗
桂树梅初熟	熟
梅花不耐秋	秋
故人知有信	信
老去不须头	不须
金缕金黄金缕金	金
水晶帘映碧云深	映
沉香殿里吹香处	香
尽是薰人妃子心	人
麦陇麦苍苍	苍
黄犹草树黄	犹
飞花忽飞去	忽
随分老农桑	分
年来宁复复	复
天地每伤心	天地
何事成何事	成
非关日夜深	非
元来元不来	元
日月辉光彩	彩
不知天上人	人
胸中有诗里	诗
园里桃花不见春	春
北风吹雨为谁云	云
桃花一阵吹香去	香
尽是桃花陌上人	人
不得一生来	生来
从头头不开	头
不知天地间	间
也自强强来	强
山云黯黯万重云	云
野水浮云处处生	生
正是故园招隐处	园
又催岩上听鸡声	催
世事从来知世事	世事
归来还自秣陵来	陵
只今惟有庭前竹	竹
终日呼童扫不开	呼
已从云外来	云外
山路如泥滑	泥
不见陌上人	人
独自将灯去	灯
万事重来不是非	非
万千千万万天机	万
古来不信音书在	书
不惹缁尘泪满衣	尘
一树无花尚有花	花
此心心物在天涯	心
涌金春色知何处	金
时有啼莺啼暮鸦	幽
不是当时节	节
方知是旧仪	旧
谁知斗杓曲	按曲
又见落花飞	飞
千年翰墨画难成	成
剪刷东风一样轻	轻
若使君王宫样少	少
与君知我亦多情	君
昔人常不受	受
春事已衰残	残
心事如今日	今日
当时须细看	须
乌鹊桥边柳色新	新
笙歌舞罢弄青春	罢
争争堤上桃花柳	争
不是闲人不恼人	闲人
王母阶前万斛珠	珠
蕊珠如玉玉如酥	玉
游人不向樽前醉	醉
却向春山卧画图	卧
夜来风雨不胜秋	秋
不见梅花总是愁	愁
匹马归来无匹马	马
马蹄行尽不曾瘳	行
醉脸初开翡翠微	微
一枝攀折向南枝	南
墙头春色浑如水	水
非是西风细雨时	非
已怯东风衮衮衣	衣
凤凰堂上燕双飞	笼
昭阳陌上黄鹂语	语
返尽残花去不归	返
万壑千山隔	隔
遥闻金谷鸟	鸟
可怜江上客	客
知君在何处	君
一日归来一日闲	闲
老来新鬓已斓斑	新
只今惟有溪边草	草
日日迟迟自往还	迟
今日归来一日闲	闲
高楼三尺对骊山	三尺
白头日日西风动	动
只在人间在世间	人间
处处多春雨	春雨
桥边送行人	行人
游人曾不见	曾
到处更无人	无人
一树梅花四十春	春
回头又见一番新	新
谁知洞府知何处	洞府
不是仙仙是主人	仙
不到浔阳陌上游	游
何人知是越南州	越
游人莫向山头话	话
落尽梨花一树秋	秋
南国重来有此心	心
更无一点碧云深	一点
门前旧事无人问	问
独坐重来一寸心	坐
一阵西风六月寒	寒
独将人泪倚阑干	人
梅花只合连云合	合
乞与梅花作雪看	雪
三十年来不记年	年
别来家里更凄然	家
如今记得今朝醉	醉
只解梅花更可怜	解
昔日登山忆故山	山
一山流水几重山	山
不知何处直归去	直
只在莓苔水石间	莓苔
打著著不著	著
出头知有余	有余
见君无著处	君
试觅谢家书	试
山色浑如画	画
谁教枕上来	教
最知安乐处	最
都是雪飞开	雪飞
百年相别若为情	情
折得归来手几茎	手
正是远山微著处	微
乱山深处与人行	轩
百年三百百	百
不是长安道	道
如此是霓裳	霓裳
又被秋风度	度
槐花落尽槐花落	花落
一树无花尚有花	花
蝴蝶不知春尽处	春
桃花深处是春家	春
万顷江头一叶舟	舟
又催吹雨送春愁	催
扁舟半夜闻风雨	闻
看尽日高不上楼	日高
万事不应难	难
归心冷於水	水
如此赋不归	赋
无心亦无复	复
山色昼如昼	昼
松间竹如竹	竹
归来消息来	消息
只在深炉里	深
白石榴花照眼明	明
主人终日下岩扃	岩
桃花知是春风处	春风
到得还家自有情	家
圣明朝汉汉	汉
万国国封侯	侯
不知何太虚	虚
不作诗中愁	诗
乌鹊桥边柳色新	新
满堤杨柳不伤春	春
夕阳春色知何处	夕阳
愁杀昭阳陌上人	人
流水登山不可寻	寻
灵光特地结人心	结
空山四月明如镜	对镜
付与诸郎到夜深	郎
尧舜是尧仁	仁
何曾有所闻	曾
莫言功德水	水
何必省诸君	省
江南江上船	船
只在高江上	高
不道故乡人	道
江南草生草	生
日日初长日	日
无花尚有花	花
若无些子子	子
今日见京华	重回
日日初长日	日
春风弄玉时	玉
不知春色胜	胜
又见水边枝	水边
白玉阶前一树阴	阴
春来草木不伤心	草木
一瓶一钵将归去	钵
只向尊前一夜深	前
三十年来尚有诗	诗
如今还是太平时	平
如今校校当前辈	阮
杜老交横更是谁	横
一树梅花四十春	春
谁将白醭拂香尘	拂
道人到处难无事	难
小摘黄梅作主人	小
朝来骤雨来	雨来
冻云冻云起	云
独卧茅檐间	间
青山还自在	自在
昨日西风泣露时	泣露
好风吹雨落花枝	风
乱红春色知何处	红
不见鸟啼花落时	红
独向山中宿	宿
看花不见春	春
梦中闻鸟语	闻
声是梦中人	声
松下长长啸	长啸
春风特地来	乞
登山未终日	终日
双眼为渠开	渠
一舸乘风入楚云	云
绿阴深处翠烟深	深
只应流出波生处	生
长与幽人住此心	住
日日归来早	早
东风又向东	东
昨日西风起	西风
残花细雨中	细雨
画戟拥浮云	拥
乾坤似使君	乾坤
往来山下路	路
秦向梦中闻	秦
一树梅花四十春	春
从来物物物精神	物
梅花应不犯寒雨	寒
莫作东风懊恼人	东风
细雨归来晚	晚
西风落叶秋	秋
归来好风雨	风雨
懒过燕山头	懒
绿柳千株绿	绿
桃花柳色空	空
一窗窗月色	窗
应不惜春红	春
孤舟立晚风	晚风
飘泊孤孤岛	孤
行人闻道来	道
只在槐阴里	阴
两鬓浑如雪	雪
梅花不是琼	琼
姮娥如玉女	娥
宫女散红妆	散
五月江头一斗牛	牛
从教人面自风流	人
老来不得知何苦	苦
赢得从来苦打头	苦
绿树阴阴覆古台	古
不知谁向腊前开	前
如今正是重阳日	日
也解春风细雨来	解
栽种庭前树	树
森森森夏木	木
落花人不见	人
唤作人间梦	梦
草色初鲜月色鲜	鲜
山中何事亦嫣然	山中
游人日日随人去	人
春草青烟锁暮烟	锁
一笑不堪笑	笑
无心奈尔何	尔
老来无限思	思
不是古来多	古
佛法从来事不通	通
孤村何处不相通	孤村
草鞋踏破庭前竹	竹
不是前身是客中	客
不见山头月	月
楼头月色新	新
春风不到处	春风
谁是是家人	家
自是一词臣	臣
偷闲是主人	闲
嘉嘉谁是主	嘉
元是圣贤臣	元
明月照明月	明月
伯伦真伯伦	孟
人人不传舍	传舍
不见枝中春	枝
金陵祠下菊花丛	丛
三十年来事始同	始
今日落花无色色	色
一花秋雨楝花风	花
礼乐谁为乐	乐
精诚不为乐	乐
不随烟雨来	烟雨
胸中有诗里	诗
梦里身为客	客
梅花乱故人	乱
蝉声不见雁	雁
随处见飞神	飞
山头风月一双双	双
陌上梅花笑未降	笑
料得胸中诗有酒	诗
一张明月入袁江	张
昨日归来看牡丹	牡丹
满园花草占春妍	春
春来不是宫无事	宫
只在桃花锦水边	锦
一树无花尚有花	花
不知今日又春斜	春
明朝又出太平处	太平
昨日归来非一家	非
昨夜昨夜雨	昨夜
西窗一纸书	书
忽从溪上去	溪
犹忆旧家书	犹
临水登山处处求	求
胸中无药不因瘳	药
此心不与形常在	形
忧患如何在所瘳	忧患
觅得重来不辨真	辨
不知官府是何人	官
争来万事成何事	争
何处相逢是故人	相逢
岩上数椽笔	笔
山中玉笋生	生
何事无人识	识
寒云听雨声	云
万里青山不见君	君
不知今日又逢君	君
胸中日日相随分	分
风雨还堪处处闻	堪
风雨在梧桐	桐
清明月受风	月
古来成底事	成
衰懒出山中	懒
春去春来不忆君	君
夜来风雨爱浮云	爱
落花不作年年事	年年
细雨梨花尚送君	尚
万事重来不是非	非
更无尘处不沾衣	尘
如今不到山河处	山河
不是等闲身不归	身
归去几重重	重
无花对北风	花
谁知一村落	村落
只在更添中	添
红叶护萱丛	丛
飞花趁晓风	晓
不知茅树下	茅
浪在白云中	浪
昔日登山忆故山	山
姓名高在白云间	高
往来岂是无穷境	境
独对南山画远山	画
风雨归来晚	晚
香犹更漏迟	犹
墙东千万里	东
不逐落花飞	飞
胸中无一字	字
胸中常有泪	泪
吾侬不忍饥	忍
泪痕泪如泪	泪痕
万事在人间	人间
虽然不可羞	羞
不知文自在	文
只在子山头	子
不入壶中别有天	天
老来一饭不成眠	眠
梦中惟有山头月	月
莫把身心试自然	试
画戟拥浮云	拥
柴门闲闭门	闲
不知花白发	花
明月弄离魂	弄
走马出长沙	长沙
馀空自在家	空
不能相料理	理
不见白杨花	鸟
百花锦如锦	锦
妾不知妾心	心
青灯无一灯	一灯
青灯今夜深	深
万仞峰头百丈高	高
小桥流水漾春涛	春
朝来照出花光处	花光
骑马寻梅上画桥	梅
一树无花尚有花	花
老来无事亦空嗟	空
也知今日非无事	非
惟有庞公自在家	公
万事不曾曾	曾
谁知隔一声	隔
头陀岩下路	路
又见桃花城	桃花
插向南山插	插
林中饭有麻	麻
胸中有双鲤	双
处处竞莲花	竞
天柱峰头百丈高	高
白云处处有惊涛	惊涛
归来便作坡仙去	仙
说与行人语半酣	语
西来天地平	平
池上柳青青	青
何人不受恩	恩
何事不堪听	不堪
江上秋风冷	冷
天寒不到家	家
朝元无一事	元
人不见梅花	人
江上青山卒未休	休
溪山佳处且迟留	留
溪山自是知人意	有意
却向青山送行舟	行舟
乐府归来暑气清	清
闭门初午听啼莺	午
看来不是亲亲事	亲
春事应须是旧情	须
一曲江头一叶舟	舟
天津桥下水烟流	烟
也知不是春风处	春风
只有愁人独自愁	人
元不是元元	元
元无一寸云	云
个中有颔尾	尾
秋气满乾坤	秋
旧事无人问	问
官官去不归	官
向来关故事	关
秋雨湿云衣	云
花开三百花	百花
光中无一片	一片
不与故人留	留
争教逞颜色	教
细雨随风度	度
南天释子猷	子
重来好山色	山色
尽是老人头	人间
万仞峰头欲插天	天
老来人物物依然	物
孤峰顶上谁曾识	曾
老子还生是几年	生
